RegionName,ZoneName,WoredaName,EthiopianMonth,EthMonNum,EthYear,DeliveredPrivateClinics,DeliveredPublicClinics,DeliveredOther,DeliveredTotal
Oromia,East Wellega,Guto Gida,Ginbot,9,2009,20,16,29,65
Oromia,Guji,Adola Reda,Tir,5,2010,31,34,69,134
Oromia,Borena,Yabelo Rural,Tahesas,4,2011,0,18,16,34
Oromia,North Shewa,Kimbibit,Hedar,3,2010,33,68,58,159
Oromia,Jimma,Nono Benja,Ginbot,9,2009,64,45,12,121
Oromia,Arsi,Aseko,Sene,10,2010,39,70,10,119
Oromia,West Wellega,Nejo Town,Hedar,3,2011,74,63,57,194
Oromia,Borena,El Way,Megabit,7,2009,12,14,43,69
Oromia,West Guji,Bule Hora,Nehase,12,2009,43,18,42,103
Oromia,Borena,Moyale,Ginbot,9,2011,83,94,89,266
Oromia,West Wellega,Gimbi Public  Hospital,Yekatit,6,2011,94,18,47,159
Oromia,East Hararge,Gole Oda,Meskerem,1,2010,94,85,52,231
Oromia,Woliso Town,Woliso Town,Hedar,3,2011,46,63,20,129
Oromia,Arsi,Gololcha,Miyazia,8,2010,72,53,84,209
Oromia,Qeleme Wellega,Gawo Qebe,Sene,10,2010,84,69,79,232
Oromia,Finfine Zuria,Walmera,Meskerem,1,2010,27,40,21,88
Oromia,East Wellega,Leqa Dulecha,Tir,5,2011,76,91,6,173
Oromia,West Shewa,Gojo Hospital,Ginbot,9,2011,63,94,43,200
Oromia,East Hararge,Haromaya Rural,Meskerem,1,2011,91,84,67,242
Oromia,West Guji,Abaya,Yekatit,6,2010,35,30,55,120
Oromia,Guji,Bore Hospital,Nehase,12,2010,44,30,51,125
Oromia,East Wellega,Guto Gida,Megabit,7,2009,90,30,15,135
Oromia,Borena,Moyale Hospital,Hamle,11,2010,86,99,59,244
Oromia,Burayu Town,Burayu Town,Miyazia,8,2009,63,48,6,117
Oromia,West Shewa,Chelia,Miyazia,8,2011,91,14,84,189
Oromia,Qeleme Wellega,Dale Sedi,Hedar,3,2010,77,82,77,236
Oromia,Qeleme Wellega,Hawa Gelan Hosp,Tir,5,2011,0,66,32,98
Oromia,East Shewa,Fentale,Megabit,7,2009,66,35,15,116
Oromia,Horo Gudru Wellega,Amuru,Tahesas,4,2010,50,50,23,123
Oromia,Finfine Zuria,Akaki,Sene,10,2009,84,39,73,196
Oromia,West Wellega,Yubdo,Hedar,3,2011,98,9,21,128
Oromia,West Shewa,Ejersa Lafo,Yekatit,6,2009,70,59,73,202
Oromia,West Hararge,Tulo,Tahesas,4,2010,63,49,8,120
Oromia,North Shewa,Kuyu,Tahesas,4,2011,29,96,57,182
Oromia,West Wellega,Mendi Town,Nehase,12,2009,79,11,91,181
Oromia,East Hararge,Chinakesen,Nehase,12,2010,1,26,91,118
Oromia,West Hararge,Tulo,Meskerem,1,2010,56,47,13,116
Oromia,Arsi,Enkelo Wabe,Hedar,3,2010,27,61,41,129
Oromia,Borena,Moyale,Sene,10,2011,2,88,48,138
Oromia,Modjo Town,Modjo Town,Hamle,11,2010,91,0,24,115
Oromia,East Shewa,Boset,Nehase,12,2009,44,68,5,117
Oromia,Arsi,Deksis,Yekatit,6,2009,89,50,98,237
Oromia,Guji,Girja,Meskerem,1,2010,43,39,17,99
Oromia,West Wellega,Guliso,Hedar,3,2010,31,35,21,87
Oromia,West Wellega,Jarso,Hedar,3,2010,71,66,6,143
Oromia,West Wellega,Gimbi Adventist Hospital,Tahesas,4,2010,3,16,19,38
Oromia,West Shewa,Ejersa Lafo,Tir,5,2009,9,38,79,126
Oromia,Bale,Goba Town,Tahesas,4,2011,16,6,3,25
Oromia,Bale,Goba Town,Nehase,12,2009,5,38,32,75
Oromia,West Shewa,Tibe Kutaye,Yekatit,6,2011,91,59,4,154
Oromia,East Wellega,Leqa Dulecha,Tir,5,2010,99,72,18,189
Oromia,South West Shewa,St.Luke Hospital,Tir,5,2011,63,71,88,222
Oromia,West Shewa,Midakegni,Yekatit,6,2009,39,81,94,214
Oromia,West Shewa,Codi,Sene,10,2010,69,72,56,197
Oromia,West Shewa,Adea Berga,Tir,5,2011,73,34,92,199
Oromia,Horo Gudru Wellega,Gudru,Tir,5,2010,74,31,13,118
Oromia,East Wellega,Boneya Bushe,Tir,5,2011,89,18,7,114
Oromia,Ilu Aba Bora,Bilonopa,Tir,5,2009,12,42,10,64
Oromia,West Arsi,Adaba,Yekatit,6,2010,10,97,78,185
Oromia,South West Shewa,St.Luke Hospital,Hedar,3,2010,38,77,67,182
Oromia,Finfine Zuria,Berreh,Meskerem,1,2010,15,33,67,115
Oromia,West Shewa,Ejersa Lafo,Tir,5,2010,41,98,26,165
Oromia,Jimma,Gera,Nehase,12,2010,18,29,87,134
Oromia,Guji,Aga Wayyu,Ginbot,9,2011,85,36,18,139
Oromia,West Hararge,Meiso,Teqemt,2,2010,92,6,0,98
Oromia,Bale,Meda Welabu,Sene,10,2009,80,15,47,142
Oromia,Bale,Raitu,Nehase,12,2009,59,8,90,157
Oromia,Bale,Goro,Yekatit,6,2009,24,86,81,191
Oromia,Lege Dadi Lege Tafo Town,Lege Dadi Lege Tafo Town,Tahesas,4,2011,6,67,15,88
Oromia,West Wellega,Nejo Rural,Megabit,7,2009,47,72,0,119
Oromia,Buno Bedele,Diga,Meskerem,1,2010,98,54,45,197
Oromia,West Shewa,Midakegni,Ginbot,9,2010,60,49,65,174
Oromia,West Shewa,Ilu Galan,Sene,10,2010,64,50,90,204
Oromia,Borena,Guchi,Sene,10,2009,74,18,16,108
Oromia,Horo Gudru Wellega,Hababo Guduru,Tir,5,2011,47,0,91,138
Oromia,West Wellega,Begi Hospital,Megabit,7,2010,40,89,19,148
Oromia,Dukem Town,Dukem Town,Ginbot,9,2010,2,72,48,122
Oromia,West Shewa,Dendi,Sene,10,2010,14,2,81,97
Oromia,Jimma,Omonada,Yekatit,6,2010,14,69,14,97
Oromia,Guji,Goro Dola,Ginbot,9,2010,57,95,6,158
Oromia,South West Shewa,Ameya,Teqemt,2,2011,83,27,15,125
Oromia,West Wellega,Nejo Town,Meskerem,1,2011,57,33,25,115
Oromia,Arsi,Merti,Teqemt,2,2010,65,62,82,209
Oromia,East Hararge,Girawa,Teqemt,2,2010,15,98,99,212
Oromia,Arsi,Ludehetosa,Miyazia,8,2010,37,3,51,91
Oromia,Bale,Legehida,Tahesas,4,2011,11,1,25,37
Oromia,West Arsi,Gedeb Asasa,Tir,5,2011,37,9,2,48
Oromia,Arsi,Aseko,Sene,10,2009,5,1,43,49
Oromia,Qeleme Wellega,Yemalogi Wolel,Miyazia,8,2010,93,83,36,212
Oromia,East Shewa,Bora,Miyazia,8,2011,84,96,65,245
Oromia,East Hararge,Kombolicha,Tir,5,2010,18,55,35,108
Oromia,Qeleme Wellega,Dambi Dollo,Megabit,7,2009,40,93,64,197
Oromia,Jimma,Limu Hospital,Tir,5,2010,54,63,20,137
Oromia,West Arsi,Shala,Hedar,3,2011,74,62,71,207
Oromia,North Shewa,Were Jarso,Teqemt,2,2010,22,36,52,110
Oromia,Ilu Aba Bora,Metu Town,Ginbot,9,2011,66,89,53,208
Oromia,West Shewa,Ambo Hospital,Meskerem,1,2011,30,14,22,66
Oromia,South West Shewa,Sodo Dac'Ha,Yekatit,6,2010,40,83,51,174
Oromia,Bale,Gasera,Nehase,12,2010,30,22,53,105
Oromia,West Shewa,Nono,Sene,10,2011,9,98,12,119
Oromia,North Shewa,Were Jarso,Miyazia,8,2011,33,11,99,143
Oromia,East Shewa,Fentale,Yekatit,6,2010,25,76,4,105
Oromia,Jimma,Omo Nada Hospital,Miyazia,8,2011,97,79,41,217
Oromia,Jimma,Gera,Meskerem,1,2011,71,42,65,178
Oromia,Finfine Zuria,Berreh,Teqemt,2,2011,40,62,31,133
Oromia,South West Shewa,Sodo Dac'Ha,Miyazia,8,2009,49,79,44,172
Oromia,North Shewa,Kuyu,Ginbot,9,2009,69,12,3,84
Oromia,Jimma Spe Town,Jimma Spe Town,Tir,5,2010,66,13,98,177
Oromia,Bale,Legehida,Sene,10,2010,5,90,82,177
Oromia,West Guji,Bule Hora,Hedar,3,2011,35,89,29,153
Oromia,Qeleme Wellega,Laloqile,Ginbot,9,2011,7,23,91,121
Oromia,Bale,Gura Dhamole,Hedar,3,2010,17,78,80,175
Oromia,South West Shewa,Tole,Meskerem,1,2011,9,62,66,137
Oromia,West Hararge,Chiro Town,Teqemt,2,2010,78,31,61,170
Oromia,Guji,Negele Hospital,Sene,10,2009,25,74,97,196
Oromia,Jimma,Seka Chekorsa,Ginbot,9,2011,25,14,78,117
Oromia,Lege Dadi Lege Tafo Town,Lege Dadi Lege Tafo Town,Megabit,7,2010,4,26,42,72
Oromia,Borena,Dubluk,Yekatit,6,2010,71,95,11,177
Oromia,Ilu Aba Bora,Didu,Tir,5,2009,30,19,72,121
Oromia,Bale,Legehida,Nehase,12,2010,46,4,7,57
Oromia,East Wellega,Gobu Seyo,Hamle,11,2010,83,14,34,131
Oromia,Arsi,Zeway Dugda,Yekatit,6,2010,31,55,61,147
Oromia,East Hararge,Garemuleta Hospital,Megabit,7,2010,42,12,31,85
Oromia,Guji,Shakiso Town,Hamle,11,2009,17,58,16,91
Oromia,West Hararge,Chiro Hospital,Tir,5,2011,92,13,30,135
Oromia,West Hararge,West Harerge	Gumbi Bordede,Sene,10,2009,3,82,86,171
Oromia,East Hararge,Deder Town,Meskerem,1,2010,4,57,80,141
Oromia,Arsi,Ludehetosa,Tahesas,4,2010,9,14,73,96
Oromia,Bale,Goba Town,Sene,10,2009,62,84,90,236
Oromia,Arsi,Bale Gesgara,Ginbot,9,2009,38,57,91,186
Oromia,Ilu Aba Bora,Halu,Yekatit,6,2009,2,90,16,108
Oromia,Arsi,Zeway Dugda,Tir,5,2010,9,3,57,69
Oromia,Jimma,B/Tolyi,Tir,5,2010,9,81,53,143
Oromia,Jimma Spe Town,Jimma Spe Town,Ginbot,9,2010,1,41,98,140
Oromia,North Shewa,Aleiltu,Tahesas,4,2010,28,14,41,83
Oromia,Qeleme Wellega,Gawo Qebe,Yekatit,6,2010,47,61,44,152
Oromia,Horo Gudru Wellega,Gudru,Nehase,12,2010,48,90,32,170
Oromia,Bale,Agarfa,Sene,10,2009,0,73,15,88
Oromia,West Hararge,Burka Dimtu,Teqemt,2,2011,90,52,26,168
Oromia,North Shewa,Girar Jarso,Yekatit,6,2011,43,43,67,153
Oromia,South West Shewa,Wonchi,Hamle,11,2009,24,79,54,157
Oromia,East Hararge,Bedeno,Tahesas,4,2011,55,18,87,160
Oromia,Finfine Zuria,Walmera,Tahesas,4,2010,86,46,84,216
Oromia,East Wellega,Gobu Seyo,Sene,10,2011,15,75,9,99
Oromia,Buno Bedele,Boricha,Sene,10,2010,72,18,77,167
Oromia,South West Shewa,Dawo,Miyazia,8,2009,87,29,16,132
Oromia,West Guji,Kercha Hospital,Hamle,11,2009,85,77,6,168
Oromia,West Shewa,Dano,Meskerem,1,2011,83,99,37,219
Oromia,North Shewa,Jido,Nehase,12,2009,8,99,14,121
Oromia,Jimma,Limu Seka,Sene,10,2009,67,35,81,183
Oromia,West Hararge,Doba,Miyazia,8,2010,8,0,10,18
Oromia,Jimma,Seka Chhokorsa Hospital,Hamle,11,2010,39,8,76,123
Oromia,North Shewa,Kuyu,Miyazia,8,2009,18,99,52,169
Oromia,North Shewa,Kuyu Hospital,Hedar,3,2011,4,18,3,25
Oromia,Qeleme Wellega,Anfilo,Teqemt,2,2011,91,80,13,184
Oromia,North Shewa,Fiche Hospital,Megabit,7,2010,74,5,21,100
Oromia,West Wellega,Seyo Nole,Hedar,3,2011,31,8,0,39
Oromia,Jimma,Nono Benja,Tahesas,4,2010,96,62,17,175
Oromia,Arsi,Sude,Ginbot,9,2009,23,51,21,95
Oromia,East Hararge,Bisidimo Hospital,Yekatit,6,2009,91,44,89,224
Oromia,Ilu Aba Bora,Darimu,Ginbot,9,2010,56,68,24,148
Oromia,East Wellega,Boneya Bushe,Tir,5,2011,81,43,47,171
Oromia,East Hararge,Midega Tole,Miyazia,8,2009,98,61,88,247
Oromia,Jimma,Nono Benja,Yekatit,6,2009,58,67,23,148
Oromia,West Wellega,Guliso,Megabit,7,2011,7,83,76,166
Oromia,Guji,Wadara,Ginbot,9,2011,78,23,47,148
Oromia,West Wellega,Lata Sibu,Ginbot,9,2010,85,98,43,226
Oromia,Buno Bedele,Dapho Hana,Ginbot,9,2009,80,89,64,233
Oromia,West Wellega,Nole Kaba,Hedar,3,2010,52,34,67,153
Oromia,East Wellega,Nunu Qumba,Megabit,7,2010,84,10,90,184
Oromia,Arsi,Merti,Ginbot,9,2009,62,77,98,237
Oromia,Buno Bedele,Bedele Zuriya,Tahesas,4,2010,59,56,16,131
Oromia,Borena,Guchi,Hedar,3,2011,61,50,0,111
Oromia,Finfine Zuria,Walmera,Ginbot,9,2009,25,94,20,139
Oromia,Qeleme Wellega,Gawo Qebe,Ginbot,9,2010,0,39,27,66
Oromia,West Shewa,Jibat,Miyazia,8,2009,50,19,53,122
Oromia,East Shewa,Fentale,Teqemt,2,2010,36,10,42,88
Oromia,Adama Special Town,Adama Town,Hamle,11,2010,5,47,47,99
Oromia,Ilu Aba Bora,Metu Rural,Nehase,12,2010,45,1,63,109
Oromia,East Hararge,Deder Town,Hedar,3,2011,30,76,93,199
Oromia,Assela Town,Assela Town,Hedar,3,2010,57,58,2,117
Oromia,West Wellega,Genji,Megabit,7,2009,50,67,57,174
Oromia,East Wellega,Kiremu,Tir,5,2010,64,66,30,160
Oromia,West Hararge,Oda Bultum,Nehase,12,2009,51,3,33,87
Oromia,East Shewa,Bora,Miyazia,8,2009,55,3,73,131
Oromia,Guji,Adola Reda,Nehase,12,2009,43,84,63,190
Oromia,East Shewa,Matahara,Hedar,3,2010,46,59,44,149
Oromia,West Wellega,Mene Sibu,Tir,5,2011,87,56,71,214
Oromia,Bale,Ginir,Tahesas,4,2010,40,83,65,188
Oromia,Guji,Hambela Wamena,Tahesas,4,2011,4,75,94,173
Oromia,West Hararge,Gelemso Hospital,Yekatit,6,2009,35,37,23,95
Oromia,North Shewa,Aleiltu,Tahesas,4,2010,67,25,37,129
Oromia,Jimma,Shabe,Tahesas,4,2010,18,29,2,49
Oromia,Jimma,Tiro Afeta,Nehase,12,2010,42,21,81,144
Oromia,East Wellega,Haro Limu,Ginbot,9,2010,4,0,34,38
Oromia,Horo Gudru Wellega,Shambu Hospital,Nehase,12,2009,64,51,27,142
Oromia,Arsi,Tena,Nehase,12,2010,11,80,68,159
Oromia,Arsi,Deksis,Hedar,3,2010,7,97,2,106
Oromia,West Arsi,Wondo,Sene,10,2009,36,54,50,140
Oromia,Ilu Aba Bora,Darimu,Teqemt,2,2010,83,3,9,95
Oromia,West Wellega,Nejo Rural,Yekatit,6,2010,62,75,97,234
Oromia,Shashamane Town,Shashamane Town,Tir,5,2010,28,31,18,77
Oromia,Borena,El Way,Hamle,11,2009,36,85,49,170
Oromia,West Hararge,Oda Bultum,Sene,10,2011,14,96,7,117
Oromia,East Hararge,Jarso,Teqemt,2,2011,53,92,6,151
Oromia,South West Shewa,Ameya Hospital,Meskerem,1,2011,35,55,22,112
Oromia,Guji,Hambela Wamena,Miyazia,8,2010,66,90,71,227
Oromia,West Wellega,Lalo Asabi,Hedar,3,2011,53,39,17,109
Oromia,West Shewa,Ejersa Lafo,Yekatit,6,2010,50,74,94,218
Oromia,Buno Bedele,Chora,Megabit,7,2009,50,7,91,148
Oromia,West Wellega,Gimbi Adventist Hospital,Tahesas,4,2011,50,44,0,94
Oromia,West Shewa,Ejerie,Tir,5,2011,66,27,71,164
Oromia,Arsi,Robe,Sene,10,2009,29,14,92,135
Oromia,Arsi,Deksis,Tahesas,4,2011,15,43,36,94
Oromia,Jimma,Omonada,Nehase,12,2009,57,40,77,174
Oromia,West Arsi,Bishan Guracha Town,Hedar,3,2010,0,41,71,112
Oromia,East Hararge,Haromaya Town,Ginbot,9,2011,56,54,12,122
Oromia,Horo Gudru Wellega,Hababo Guduru,Hedar,3,2010,62,83,44,189
Oromia,Arsi,Digeluna Tijo,Tahesas,4,2010,33,78,17,128
Oromia,East Hararge,Deder Hospital,Yekatit,6,2010,61,11,17,89
Oromia,East Wellega,Boneya Bushe,Ginbot,9,2010,46,23,4,73
Oromia,Jimma,Limu Seka,Teqemt,2,2011,67,18,16,101
Oromia,Jimma,Seka Chekorsa,Hedar,3,2011,8,64,66,138
Oromia,Arsi,Bekoji Town,Tahesas,4,2011,71,93,89,253
Oromia,Bale,Raitu,Nehase,12,2009,54,65,2,121
Oromia,Bale,Gasera,Tir,5,2011,37,83,10,130
Oromia,Ilu Aba Bora,Metu Rural,Tir,5,2010,54,85,83,222
Oromia,Guji,Wadara,Meskerem,1,2010,63,88,40,191
Oromia,East Wellega,Leqa Dulecha,Ginbot,9,2010,96,4,72,172
Oromia,Arsi,Tena,Miyazia,8,2011,66,57,79,202
Oromia,Ilu Aba Bora,Bure,Sene,10,2011,12,39,64,115
Oromia,South West Shewa,Kersana Malima,Megabit,7,2009,92,57,32,181
Oromia,East Hararge,Garemuleta Hospital,Miyazia,8,2011,18,91,75,184
Oromia,Guji,Hambela Wamena,Yekatit,6,2010,65,33,41,139
Oromia,Borena,Wachile,Tahesas,4,2010,9,58,42,109
Oromia,West Hararge,Meiso,Ginbot,9,2011,69,13,7,89
Oromia,West Shewa,Tikur Enchini,Megabit,7,2010,62,34,73,169
Oromia,North Shewa,Dera Hospital,Meskerem,1,2010,11,26,38,75
Oromia,Jimma,Mancho,Sene,10,2010,87,16,42,145
Oromia,West Wellega,Mendi Hospital,Meskerem,1,2011,11,6,56,73
Oromia,Guji,Saba Boru,Nehase,12,2010,26,96,89,211
Oromia,West Shewa,Bako Tibe,Sene,10,2009,71,92,63,226
Oromia,West Hararge,Gelemso Hospital,Teqemt,2,2011,43,30,11,84
Oromia,West Guji,Bule Hora,Ginbot,9,2009,38,89,52,179
Oromia,West Shewa,Dendi,Miyazia,8,2010,95,78,18,191
Oromia,East Wellega,Gudeyabila,Meskerem,1,2010,99,1,85,185
Oromia,Bale,Delo Mena,Nehase,12,2009,99,68,62,229
Oromia,East Hararge,Melka Belo,Meskerem,1,2011,74,27,52,153
Oromia,Jimma,Chora Boter,Tahesas,4,2011,97,83,28,208
Oromia,East Hararge,Bisidimo Hospital,Megabit,7,2011,79,88,25,192
Oromia,South West Shewa,St.Luke Hospital,Miyazia,8,2009,3,84,63,150
Oromia,West Shewa,Codi,Teqemt,2,2010,84,30,3,117
Oromia,West Arsi,Arsi Negele Town,Sene,10,2009,35,3,31,69
Oromia,Ilu Aba Bora,Bilonopa,Nehase,12,2010,4,87,26,117
Oromia,West Shewa,Ambo,Hedar,3,2011,48,44,55,147
Oromia,Arsi,Bale Gesgara,Yekatit,6,2009,91,72,26,189
Oromia,Jimma,Sigmo,Nehase,12,2009,54,86,36,176
Oromia,Arsi,Hitosa,Hamle,11,2010,61,12,33,106
Oromia,West Arsi,Gedeb Asasa,Sene,10,2009,16,39,2,57
Oromia,West Shewa,Ambo,Megabit,7,2011,41,92,9,142
Oromia,West Shewa,Elifata,Ginbot,9,2010,22,10,38,70
Oromia,East Hararge,Haromaya Rural,Yekatit,6,2011,0,36,63,99
Oromia,Arsi,Zeway Dugda,Hamle,11,2010,19,90,93,202
Oromia,Jimma,Mancho,Ginbot,9,2011,71,79,33,183
Oromia,Finfine Zuria,Sandefa,Ginbot,9,2011,14,15,93,122
Oromia,East Shewa,Liben,Yekatit,6,2009,64,84,54,202
Oromia,West Hararge,Guba Qoricha,Nehase,12,2009,95,55,48,198
Oromia,Jimma,Nono Benja,Hamle,11,2010,29,46,87,162
Oromia,Ilu Aba Bora,Halu,Tir,5,2010,77,82,45,204
Oromia,South West Shewa,Wonchi,Meskerem,1,2011,35,34,26,95
Oromia,South West Shewa,Sodo Dac'Ha,Tahesas,4,2010,79,97,26,202
Oromia,West Shewa,Ambo,Sene,10,2010,38,72,27,137
Oromia,Ilu Aba Bora,Doreni,Tahesas,4,2011,84,86,77,247
Oromia,West Hararge,Chiro Town,Yekatit,6,2010,59,77,36,172
Oromia,Qeleme Wellega,Sedan Chanka,Tahesas,4,2011,20,92,51,163
Oromia,Guji,Hambela Wamena,Hamle,11,2009,92,17,86,195
Oromia,Arsi,Bekoji Town,Teqemt,2,2010,89,52,72,213
Oromia,Buno Bedele,Bedele Zuriya,Hedar,3,2010,93,95,23,211
Oromia,West Hararge,Chiro Zuriya,Miyazia,8,2011,68,1,3,72
Oromia,West Guji,Bule Hora Toun,Hedar,3,2010,45,13,94,152
Oromia,Borena,Moyale,Teqemt,2,2011,95,94,70,259
Oromia,Guji,Hambela Wamena,Megabit,7,2010,79,43,71,193
Oromia,East Shewa,Gimbichu,Hedar,3,2011,13,81,36,130
Oromia,Adama Special Town,Adama Town,Sene,10,2009,99,74,78,251
Oromia,Jimma,Mana,Yekatit,6,2010,37,69,28,134
Oromia,East Hararge,Girawa,Miyazia,8,2009,56,21,16,93
Oromia,Guji,Adola Hospital,Sene,10,2011,63,19,53,135
Oromia,Jimma,Sekoru,Tir,5,2011,32,92,40,164
Oromia,Qeleme Wellega,Hawa Gelan,Hedar,3,2010,31,24,86,141
Oromia,Bale,Legehida,Yekatit,6,2011,31,71,8,110
Oromia,Bale,Seweyna,Ginbot,9,2009,68,16,80,164
Oromia,West Arsi,Arsi Negele Rural,Sene,10,2011,5,49,36,90
Oromia,West Hararge,Bedesa Town,Nehase,12,2009,54,61,98,213
Oromia,South West Shewa,Dawo,Hedar,3,2010,71,66,39,176
Oromia,West Shewa,Inchini Hospital,Meskerem,1,2010,64,60,84,208
Oromia,West Wellega,Homa,Ginbot,9,2011,49,22,56,127
Oromia,West Guji,Hanbala,Sene,10,2009,70,49,96,215
Oromia,East Hararge,Girawa,Tahesas,4,2011,18,23,47,88
Oromia,Ilu Aba Bora,Becho,Hedar,3,2011,16,82,20,118
Oromia,West Shewa,Meta Waliqite,Megabit,7,2010,60,43,37,140
Oromia,Finfine Zuria,Mullo,Teqemt,2,2011,16,37,39,92
Oromia,Arsi,Digeluna Tijo,Tahesas,4,2011,17,22,91,130
Oromia,Qeleme Wellega,Dale Wabera,Sene,10,2010,74,68,65,207
Oromia,South West Shewa,Wonchi,Ginbot,9,2010,0,64,18,82
Oromia,Guji,Negele Hospital,Sene,10,2009,78,40,83,201
Oromia,East Shewa,Liben,Hedar,3,2011,21,13,46,80
Oromia,Borena,Dilo,Tahesas,4,2010,50,20,5,75
Oromia,Guji,Adola Reda,Sene,10,2011,53,96,94,243
Oromia,West Arsi,Bishan Guracha Town,Tahesas,4,2010,27,98,85,210
Oromia,Buno Bedele,Gechi,Tir,5,2010,7,11,87,105
Oromia,Guji,Saba Boru,Ginbot,9,2010,48,87,59,194
Oromia,Jimma,Gera,Sene,10,2009,99,67,91,257
Oromia,South West Shewa,Wonchi,Nehase,12,2009,58,86,79,223
Oromia,Horo Gudru Wellega,Shambu Hospital,Meskerem,1,2010,77,14,28,119
Oromia,West Arsi,Arsi Negele Rural,Megabit,7,2011,51,51,28,130
Oromia,Ilu Aba Bora,Yayu,Hedar,3,2011,83,24,13,120
Oromia,West Shewa,Elifata,Teqemt,2,2010,56,57,61,174
Oromia,South West Shewa,Ameya,Nehase,12,2010,46,10,30,86
Oromia,West Shewa,Dano,Tir,5,2011,19,99,10,128
Oromia,West Shewa,Ambo Hospital,Yekatit,6,2011,97,40,95,232
Oromia,East Hararge,Melka Belo,Ginbot,9,2011,97,91,81,269
Oromia,Buno Bedele,Bedele Hospital,Yekatit,6,2009,43,74,78,195
Oromia,North Shewa,Debre Libanos,Tir,5,2009,36,72,12,120
Oromia,Buno Bedele,Dapho Hana,Nehase,12,2010,8,76,74,158
Oromia,East Hararge,Deder,Sene,10,2009,17,60,49,126
Oromia,West Wellega,Homa,Yekatit,6,2009,38,37,78,153
Oromia,West Hararge,Gemechis,Nehase,12,2009,41,25,66,132
Oromia,West Guji,Bule Hora,Yekatit,6,2011,25,76,84,185
Oromia,Arsi,Bekoji Town,Ginbot,9,2009,11,27,42,80
Oromia,East Shewa,Matahara,Ginbot,9,2011,11,93,58,162
Oromia,Guji,Bore Hospital,Nehase,12,2010,38,80,19,137
Oromia,South West Shewa,St.Luke Hospital,Megabit,7,2009,44,5,84,133
Oromia,Bale,Arena Buluq,Hedar,3,2011,73,63,28,164
Oromia,West Arsi,Kokosa,Yekatit,6,2011,71,63,36,170
Oromia,West Wellega,Haru,Tir,5,2009,28,76,33,137
Oromia,East Wellega,Gobu Seyo,Hamle,11,2010,61,86,97,244
Oromia,Arsi,Guna,Megabit,7,2009,61,11,90,162
Oromia,West Guji,Kercha,Miyazia,8,2011,64,42,65,171
Oromia,Arsi,Merti,Sene,10,2010,36,96,64,196
Oromia,West Wellega,Nejo Town,Tahesas,4,2010,35,35,13,83
Oromia,Assela Town,Assela Town,Miyazia,8,2010,23,0,28,51
Oromia,West Shewa,Dano,Miyazia,8,2011,46,89,50,185
Oromia,West Shewa,Ambo,Tahesas,4,2010,7,9,70,86
Oromia,South West Shewa,Kersana Malima,Meskerem,1,2011,38,85,35,158
Oromia,West Arsi,Dodola Rural,Meskerem,1,2011,80,6,25,111
Oromia,Bale,Legehida,Miyazia,8,2011,39,86,38,163
Oromia,Buno Bedele,Dedesa,Megabit,7,2010,78,93,46,217
Oromia,Finfine Zuria,Sebeta Awas,Nehase,12,2009,66,78,42,186
Oromia,Borena,Dhas,Megabit,7,2011,65,1,52,118
Oromia,West Wellega,Genji,Miyazia,8,2011,29,83,60,172
Oromia,Guji,Negele Town,Hamle,11,2010,32,49,58,139
Oromia,Ilu Aba Bora,Bilonopa,Hamle,11,2010,99,96,14,209
Oromia,West Arsi,Arsi Negele Rural,Sene,10,2011,88,75,96,259
Oromia,West Shewa,Dano,Ginbot,9,2010,51,0,92,143
Oromia,West Wellega,Gimbi Adventist Hospital,Yekatit,6,2009,75,59,75,209
Oromia,West Hararge,Burka Dimtu,Nehase,12,2009,24,86,13,123
Oromia,Guji,Saba Boru,Tahesas,4,2011,10,27,80,117
Oromia,West Wellega,Gimbi Rural,Ginbot,9,2011,94,22,24,140
Oromia,North Shewa,Aleiltu,Teqemt,2,2011,51,60,36,147
Oromia,West Hararge,Chiro Zuriya,Miyazia,8,2009,6,33,50,89
Oromia,East Hararge,Girawa,Sene,10,2011,79,85,60,224
Oromia,Borena,El Way,Miyazia,8,2009,36,51,11,98
Oromia,West Hararge,Habro,Tir,5,2010,85,43,75,203
Oromia,Modjo Town,Modjo Town,Hedar,3,2011,1,56,87,144
Oromia,West Wellega,Gimbi Rural,Tir,5,2011,18,34,74,126
Oromia,West Shewa,Elifata,Hedar,3,2011,74,10,83,167
Oromia,East Wellega,Leqa Dulecha,Yekatit,6,2010,19,32,68,119
Oromia,Guji,Bore Hospital,Hamle,11,2010,16,52,66,134
Oromia,Qeleme Wellega,Dambi Dolo Hospital,Hamle,11,2009,90,33,8,131
Oromia,West Shewa,Ambo University  Hosp,Ginbot,9,2011,3,22,2,27
Oromia,West Wellega,Gimbi,Hamle,11,2010,91,74,97,262
Oromia,East Shewa,Matahara,Sene,10,2009,84,16,86,186
Oromia,West Wellega,Nejo Town,Tir,5,2011,56,95,37,188
Oromia,Arsi,Dodota,Megabit,7,2010,70,0,60,130
Oromia,West Shewa,Ginde Beret,Meskerem,1,2011,74,48,59,181
Oromia,North Shewa,Kuyu,Ginbot,9,2010,3,58,55,116
Oromia,Jimma,Sigmo,Teqemt,2,2010,71,67,95,233
Oromia,East Hararge,Goro Muti,Sene,10,2011,96,75,28,199
Oromia,Lege Dadi Lege Tafo Town,Lege Dadi Lege Tafo Town,Nehase,12,2010,79,81,11,171
Oromia,Arsi,Munesa,Megabit,7,2010,62,74,33,169
Oromia,West Arsi,Arsi Negele Rural,Hamle,11,2010,9,26,24,59
Oromia,South West Shewa,Woliso Rural,Hedar,3,2011,24,60,95,179
Oromia,Qeleme Wellega,Gawo Qebe,Ginbot,9,2010,85,78,0,163
Oromia,West Arsi,Kore,Tahesas,4,2011,20,56,63,139
Oromia,Finfine Zuria,Walmera,Meskerem,1,2010,27,20,30,77
Oromia,Jimma,Chora Boter,Megabit,7,2009,61,37,84,182
Oromia,Guji,Odo Shakiso,Miyazia,8,2011,84,27,42,153
Oromia,West Arsi,Shashemene Rural,Megabit,7,2011,41,3,41,85
Oromia,East Shewa,Gimbichu,Teqemt,2,2011,35,17,37,89
Oromia,West Hararge,Daro Lebu,Hamle,11,2009,72,33,44,149
Oromia,South West Shewa,Becho,Hedar,3,2010,68,72,57,197
Oromia,West Wellega,Mendi Hospital,Tahesas,4,2010,84,82,83,249
Oromia,West Hararge,Bedesa Town,Miyazia,8,2010,13,56,43,112
Oromia,West Guji,Abaya,Ginbot,9,2009,86,94,2,182
Oromia,East Wellega,Gudeyabila,Tir,5,2010,0,80,70,150
Oromia,Arsi,Hitosa,Tahesas,4,2010,71,73,1,145
Oromia,East Shewa,Gimbichu,Tahesas,4,2010,45,98,42,185
Oromia,Ilu Aba Bora,Yayu,Megabit,7,2009,81,63,54,198
Oromia,East Wellega,Guto Gida,Sene,10,2009,59,73,25,157
Oromia,South West Shewa,Ilu,Hamle,11,2010,95,66,19,180
Oromia,Finfine Zuria,Sebeta Awas,Megabit,7,2011,59,12,7,78
Oromia,Guji,Wadara,Yekatit,6,2009,77,54,72,203
Oromia,East Hararge,Gole Oda,Miyazia,8,2011,70,96,51,217
Oromia,Buno Bedele,Meko,Megabit,7,2009,46,65,29,140
Oromia,West Guji,Abaya,Yekatit,6,2010,51,62,22,135
Oromia,West Shewa,Gedo Hospital,Ginbot,9,2009,48,46,12,106
Oromia,West Arsi,Nensebo,Hamle,11,2010,21,27,4,52
Oromia,Buno Bedele,Bedele Town,Meskerem,1,2011,30,49,68,147
Oromia,Finfine Zuria,Berreh,Hedar,3,2010,86,6,63,155
Oromia,Robe Town,Robe Town,Hedar,3,2010,78,60,42,180
Oromia,Bale,Gasera,Ginbot,9,2009,20,77,52,149
Oromia,Finfine Zuria,Mullo,Tahesas,4,2010,67,63,98,228
Oromia,West Hararge,Gelemso Hospital,Hedar,3,2011,66,57,75,198
Oromia,Ilu Aba Bora,Hurumu,Hedar,3,2011,96,10,84,190
Oromia,Sebeta Town,Sebeta Town,Tir,5,2009,99,73,33,205
Oromia,Buno Bedele,Chora,Nehase,12,2009,40,86,36,162
Oromia,South West Shewa,Woliso Rural,Hedar,3,2010,4,58,54,116
Oromia,Bale,Dawe Serar,Hamle,11,2009,61,39,62,162
Oromia,East Wellega,Kiremu,Hedar,3,2010,92,11,90,193
Oromia,West Shewa,Guder Hosp,Hedar,3,2010,77,73,35,185
Oromia,West Arsi,Wondo,Ginbot,9,2009,92,55,39,186
Oromia,Modjo Town,Modjo Town,Hedar,3,2010,42,80,61,183
Oromia,Guji,Adola Hospital,Megabit,7,2009,22,81,19,122
Oromia,East Hararge,Midega Tole,Hamle,11,2009,18,85,90,193
Oromia,East Wellega,Sibu Sire,Tahesas,4,2011,83,95,48,226
Oromia,East Hararge,Garemuleta Hospital,Sene,10,2011,24,45,16,85
Oromia,Jimma,Shabe,Meskerem,1,2011,90,24,34,148
Oromia,West Arsi,Dodola  Hospital,Megabit,7,2010,42,7,6,55
Oromia,East Hararge,Babile Woreda,Megabit,7,2011,98,99,46,243
Oromia,Buno Bedele,Bedele Town,Miyazia,8,2011,28,39,46,113
Oromia,Arsi,Limuna Bilbilo,Hedar,3,2010,60,0,28,88
Oromia,West Shewa,Gindeberet Hospital,Tahesas,4,2011,1,96,42,139
Oromia,West Wellega,Seyo Nole,Yekatit,6,2010,97,52,89,238
Oromia,Borena,Arero,Tir,5,2010,40,77,40,157
Oromia,Arsi,Shirka,Yekatit,6,2010,96,50,35,181
Oromia,Jimma,Tiro Afeta,Tahesas,4,2011,83,94,18,195
Oromia,West Wellega,Ayira Hospital,Miyazia,8,2010,3,96,78,177
Oromia,West Hararge,West Harerge	Gumbi Bordede,Teqemt,2,2010,58,58,58,174
Oromia,Nekemte Town,Nekemte Town,Teqemt,2,2011,23,16,7,46
Oromia,Arsi,Tena,Ginbot,9,2011,86,42,53,181
Oromia,West Arsi,Gedeb Asasa,Ginbot,9,2010,15,90,69,174
Oromia,West Guji,Gelana,Tir,5,2009,1,67,44,112
Oromia,West Hararge,Meiso,Nehase,12,2010,65,21,33,119
Oromia,Borena,Arero,Tir,5,2010,11,92,25,128
Oromia,West Hararge,Chiro Hospital,Tahesas,4,2011,68,58,42,168
Oromia,Bale,Seweyna,Hedar,3,2010,51,53,70,174
Oromia,West Wellega,Mendi Town,Tahesas,4,2010,86,74,59,219
Oromia,West Guji,Kercha Hospital,Ginbot,9,2011,35,88,23,146
Oromia,East Wellega,Wayu Tuqa,Ginbot,9,2011,41,45,57,143
Oromia,Jimma,Omonada,Meskerem,1,2011,54,98,84,236
Oromia,North Shewa,Were Jarso,Nehase,12,2010,4,80,87,171
Oromia,East Wellega,Gobu Seyo,Hedar,3,2011,22,84,69,175
Oromia,West Shewa,Ambo Hospital,Teqemt,2,2011,59,14,84,157
Oromia,Jimma,Mancho,Teqemt,2,2010,46,26,79,151
Oromia,West Arsi,Arsi Negele Rural,Teqemt,2,2011,61,54,9,124
Oromia,Jimma,Shabe,Hamle,11,2010,62,2,56,120
Oromia,West Wellega,Haru,Sene,10,2009,58,82,92,232
Oromia,Bale,Meda Welabu,Megabit,7,2011,87,36,78,201
Oromia,North Shewa,Kuyu Hospital,Ginbot,9,2010,57,48,36,141
Oromia,Borena,Dhas,Ginbot,9,2010,89,75,74,238
Oromia,West Hararge,Meiso,Tir,5,2011,13,94,10,117
Oromia,Assela Town,Assela Town,Hedar,3,2011,93,37,76,206
Oromia,East Shewa,Batu,Meskerem,1,2010,30,13,28,71
Oromia,Finfine Zuria,Walmera,Ginbot,9,2009,85,71,49,205
Oromia,East Wellega,Wama Hagelo,Hedar,3,2011,86,25,60,171
Oromia,Finfine Zuria,Mullo,Tir,5,2010,64,15,73,152
Oromia,Jimma,Mana,Teqemt,2,2011,45,95,49,189
Oromia,Jimma,Mancho,Yekatit,6,2011,70,37,43,150
Oromia,Jimma,Limu Kosa,Tir,5,2011,32,98,22,152
Oromia,Nekemte Town,Nekemte Town,Teqemt,2,2010,94,7,68,169
Oromia,East Hararge,Haromaya Town,Megabit,7,2009,52,83,11,146
Oromia,Borena,Meyo,Hamle,11,2010,55,85,63,203
Oromia,West Wellega,Gimbi Public  Hospital,Nehase,12,2010,84,47,47,178
Oromia,East Shewa,Bora,Sene,10,2011,14,31,58,103
Oromia,West Shewa,Liban Jawi,Miyazia,8,2009,98,48,54,200
Oromia,West Arsi,Gedeb Asasa,Yekatit,6,2010,90,11,57,158
Oromia,Buno Bedele,Chewaqa,Hedar,3,2011,58,93,44,195
Oromia,Woliso Town,Woliso Town,Hedar,3,2011,65,41,69,175
Oromia,Bale,Seweyna,Nehase,12,2009,6,28,85,119
Oromia,Arsi,Digeluna Tijo,Sene,10,2011,7,16,72,95
Oromia,North Shewa,Fichetown,Meskerem,1,2010,93,1,36,130
Oromia,Buno Bedele,Diga,Ginbot,9,2009,7,45,50,102
Oromia,North Shewa,Hidabu Abote,Nehase,12,2010,94,44,71,209
Oromia,East Hararge,Deder,Teqemt,2,2010,2,40,31,73
Oromia,Ilu Aba Bora,Metu Rural,Teqemt,2,2010,66,67,26,159
Oromia,Assela Town,Assela Town,Sene,10,2010,95,64,91,250
Oromia,West Shewa,Ejersa Lafo,Tahesas,4,2010,21,52,73,146
Oromia,West Hararge,Chiro Hospital,Megabit,7,2009,34,67,86,187
Oromia,East Wellega,Wayu Tuqa,Megabit,7,2009,85,28,30,143
Oromia,Shashamane Town,Shashamane Town,Tir,5,2009,42,94,36,172
Oromia,West Arsi,Adaba,Hamle,11,2009,25,98,14,137
Oromia,Horo Gudru Wellega,Hababo Guduru,Yekatit,6,2009,11,27,35,73
Oromia,South West Shewa,Ameya Hospital,Megabit,7,2011,97,10,89,196
Oromia,West Hararge,Habro,Meskerem,1,2011,22,90,55,167
Oromia,West Hararge,Hawi Gudina,Miyazia,8,2010,81,44,47,172
Oromia,West Shewa,Gindeberet Hospital,Hedar,3,2010,83,92,92,267
Oromia,West Arsi,Arsi Negele Rural,Megabit,7,2010,35,11,65,111
Oromia,Jimma,Setema,Miyazia,8,2009,45,99,32,176
Oromia,Adama Special Town,Adama Town,Ginbot,9,2011,42,11,91,144
Oromia,East Hararge,Deder Town,Yekatit,6,2011,56,38,6,100
Oromia,East Hararge,Kersa Eh,Ginbot,9,2011,9,62,37,108
Oromia,Finfine Zuria,Holeta,Sene,10,2009,5,62,44,111
Oromia,Buno Bedele,Meko,Nehase,12,2009,16,60,9,85
Oromia,Horo Gudru Wellega,Jima Geneti,Tir,5,2009,56,31,47,134
Oromia,West Shewa,Jeldu,Ginbot,9,2010,76,72,33,181
Oromia,Borena,Arero,Nehase,12,2009,20,5,40,65
Oromia,Horo Gudru Wellega,Hababo Guduru,Tir,5,2009,22,23,25,70
Oromia,West Hararge,Burka Dimtu,Miyazia,8,2011,29,27,35,91
Oromia,West Wellega,Nejo Rural,Hedar,3,2010,73,0,38,111
Oromia,Qeleme Wellega,Hawa Gelan,Megabit,7,2009,62,77,34,173
Oromia,Bale,Berbere,Megabit,7,2009,40,2,93,135
Oromia,East Hararge,Jarso,Megabit,7,2011,89,31,13,133
Oromia,North Shewa,Jido,Megabit,7,2010,62,9,92,163
Oromia,Jimma,Sekoru,Ginbot,9,2011,40,61,1,102
Oromia,Qeleme Wellega,Hawa Gelan,Ginbot,9,2011,52,96,97,245
Oromia,Woliso Town,Woliso Town,Teqemt,2,2011,18,36,53,107
Oromia,West Arsi,Dodola Town,Ginbot,9,2010,74,59,73,206
Oromia,East Shewa,Fentale,Megabit,7,2009,84,93,33,210
Oromia,Guji,Anna Sora,Nehase,12,2010,18,80,64,162
Oromia,Jimma,Sekoru,Yekatit,6,2011,16,36,92,144
Oromia,South West Shewa,Ameya,Tir,5,2010,22,63,78,163
Oromia,West Wellega,Gimbi Adventist Hospital,Ginbot,9,2010,66,72,65,203
Oromia,Jimma,Shabe,Megabit,7,2009,13,98,69,180
Oromia,North Shewa,Debre Libanos,Hedar,3,2011,24,76,86,186
Oromia,Horo Gudru Wellega,Amuru,Tir,5,2011,87,57,42,186
Oromia,Bale,Agarfa,Ginbot,9,2009,27,38,28,93
Oromia,West Wellega,Mene Sibu,Teqemt,2,2010,39,85,50,174
Oromia,Qeleme Wellega,Seyo,Megabit,7,2010,34,3,0,37
Oromia,Ilu Aba Bora,Becho,Tir,5,2009,50,36,82,168
Oromia,West Arsi,Gambo Hospital,Hamle,11,2009,65,74,17,156
Oromia,West Hararge,Mesela,Teqemt,2,2011,29,82,35,146
Oromia,Ilu Aba Bora,Halu,Hedar,3,2011,67,60,19,146
Oromia,West Shewa,Dano,Miyazia,8,2010,36,76,5,117
Oromia,East Wellega,Limu,Meskerem,1,2010,94,55,25,174
Oromia,South West Shewa,Dawo,Ginbot,9,2009,17,97,45,159
Oromia,West Arsi,Dodola  Hospital,Nehase,12,2010,65,68,48,181
Oromia,East Wellega,Sasiga,Meskerem,1,2011,82,83,25,190
Oromia,Guji,Bore,Hedar,3,2011,37,63,72,172
Oromia,West Guji,Abaya,Tahesas,4,2011,19,82,53,154
Oromia,Finfine Zuria,Sandefa,Sene,10,2010,38,14,18,70
Oromia,Arsi,Shenan Kolu,Hamle,11,2009,90,4,65,159
Oromia,Ilu Aba Bora,Halu,Tir,5,2009,48,3,93,144
Oromia,Qeleme Wellega,Dambi Dollo,Hamle,11,2010,81,70,93,244
Oromia,Arsi,Jeju,Sene,10,2011,70,54,53,177
Oromia,Borena,Dire,Yekatit,6,2009,80,79,20,179
Oromia,West Guji,Hanbala,Tir,5,2010,8,10,65,83
Oromia,East Wellega,Boneya Bushe,Tir,5,2010,4,30,2,36
Oromia,Modjo Town,Modjo Town,Megabit,7,2011,51,89,16,156
Oromia,Arsi,Bekoji Town,Sene,10,2010,60,86,19,165
Oromia,Ilu Aba Bora,Doreni,Meskerem,1,2010,18,90,39,147
Oromia,Assela Town,Assela Town,Hamle,11,2009,68,29,7,104
Oromia,Buno Bedele,Meko,Teqemt,2,2010,73,6,62,141
Oromia,Jimma,B/Tolyi,Hedar,3,2011,73,65,47,185
Oromia,East Wellega,Sasiga,Tir,5,2011,71,37,47,155
Oromia,Buno Bedele,Chora,Miyazia,8,2010,30,94,88,212
Oromia,East Hararge,Bedeno,Sene,10,2011,22,19,5,46
Oromia,North Shewa,Jido,Ginbot,9,2011,60,52,89,201
Oromia,Borena,Dhas,Miyazia,8,2010,72,19,25,116
Oromia,Qeleme Wellega,Anfilo,Ginbot,9,2011,22,56,34,112
Oromia,Buno Bedele,Meko,Sene,10,2009,88,31,58,177
Oromia,Borena,Moyale Hospital,Tahesas,4,2011,65,86,69,220
Oromia,Borena,Dire,Nehase,12,2010,11,47,11,69
Oromia,Finfine Zuria,Walmera,Nehase,12,2010,84,38,9,131
Oromia,Guji,Wadara,Yekatit,6,2011,32,41,94,167
Oromia,Buno Bedele,Gechi,Meskerem,1,2011,72,65,49,186
Oromia,West Hararge,Meiso,Tahesas,4,2011,70,62,86,218
Oromia,Jimma,Limu Kosa,Hedar,3,2011,13,29,94,136
Oromia,Arsi,Bale Gesgara,Hedar,3,2011,54,78,69,201
Oromia,Buno Bedele,Boricha,Teqemt,2,2011,44,84,0,128
Oromia,Bishoftu Town,Bishoftu Town,Hamle,11,2009,49,10,14,73
Oromia,West Shewa,Ilu Galan,Tahesas,4,2011,85,94,37,216
Oromia,West Wellega,Nejo Hospital,Miyazia,8,2009,51,96,61,208
Oromia,West Wellega,Boji Cheqorsa,Sene,10,2011,98,66,41,205
Oromia,Adama Special Town,Adama Town,Yekatit,6,2009,55,14,92,161
Oromia,Modjo Town,Modjo Town,Hedar,3,2010,41,34,66,141
Oromia,East Wellega,Gobu Seyo,Megabit,7,2010,11,13,99,123
Oromia,West Hararge,Guba Qoricha,Tir,5,2010,77,95,15,187
Oromia,Assela Town,Assela Town,Hamle,11,2010,33,46,84,163
Oromia,North Shewa,Kimbibit,Hamle,11,2010,83,20,98,201
Oromia,Jimma,Omonada,Megabit,7,2011,51,25,91,167
Oromia,North Shewa,Dera Hospital,Tir,5,2011,90,19,54,163
Oromia,South West Shewa,Dawo,Ginbot,9,2011,44,32,75,151
Oromia,West Arsi,Gambo Hospital,Megabit,7,2010,35,94,59,188
Oromia,Buno Bedele,Diga,Miyazia,8,2010,81,73,17,171
Oromia,Arsi,Digeluna Tijo,Tir,5,2011,14,71,36,121
Oromia,Jimma,Omo Nada Hospital,Tir,5,2011,29,23,65,117
Oromia,East Shewa,Adama,Hedar,3,2011,59,47,77,183
Oromia,West Guji,Kercha Hospital,Hamle,11,2010,80,69,73,222
Oromia,Finfine Zuria,Holeta,Nehase,12,2009,40,41,9,90
Oromia,West Hararge,Gelemso Hospital,Tir,5,2010,28,82,67,177
Oromia,Bale,Dinsho,Tir,5,2010,61,17,12,90
Oromia,West Shewa,Gojo Hospital,Tir,5,2010,90,30,30,150
Oromia,Guji,Bore,Ginbot,9,2011,48,15,73,136
Oromia,Finfine Zuria,Mullo,Megabit,7,2009,21,39,88,148
Oromia,West Arsi,Dodola Town,Sene,10,2009,45,50,94,189
Oromia,West Hararge,Bedesa Town,Tir,5,2011,47,80,87,214
Oromia,West Hararge,Boke,Teqemt,2,2011,9,34,88,131
Oromia,Jimma,Gera,Tir,5,2009,78,25,43,146
Oromia,West Shewa,Nono,Ginbot,9,2011,22,41,75,138
Oromia,Finfine Zuria,Sebeta Awas,Megabit,7,2010,35,64,79,178
Oromia,West Wellega,Mendi Town,Nehase,12,2009,58,70,67,195
Oromia,Arsi,Bale Gesgara,Sene,10,2011,87,76,37,200
Oromia,West Arsi,Bishan Guracha Town,Miyazia,8,2010,8,16,43,67
Oromia,Nekemte Town,Nekemte Town,Yekatit,6,2011,75,16,31,122
Oromia,Buno Bedele,Dapho Hana,Hedar,3,2010,80,65,70,215
Oromia,North Shewa,Kimbibit,Hamle,11,2010,39,43,88,170
Oromia,Finfine Zuria,Mullo,Teqemt,2,2010,74,39,32,145
Oromia,East Hararge,Meyu Muleke,Ginbot,9,2011,89,2,56,147
Oromia,West Wellega,Begi Hospital,Teqemt,2,2010,76,99,11,186
Oromia,Qeleme Wellega,Gidami,Tir,5,2009,32,96,32,160
Oromia,West Wellega,Homa,Yekatit,6,2010,10,53,17,80
Oromia,West Shewa,Nono,Tahesas,4,2010,22,1,62,85
Oromia,Arsi,Robe,Teqemt,2,2011,88,29,4,121
Oromia,South West Shewa,Tulu Bolo Hospital,Hedar,3,2010,22,90,95,207
Oromia,East Hararge,Deder Hospital,Hedar,3,2010,62,12,25,99
Oromia,East Wellega,Guto Gida,Nehase,12,2010,24,80,9,113
Oromia,East Wellega,Gobu Seyo,Ginbot,9,2011,92,71,53,216
Oromia,West Hararge,Guba Qoricha,Tir,5,2011,7,76,48,131
Oromia,West Shewa,Nono,Ginbot,9,2010,5,23,54,82
Oromia,Buno Bedele,Meko,Miyazia,8,2011,52,75,1,128
Oromia,East Wellega,Boneya Bushe,Meskerem,1,2010,9,46,10,65
Oromia,Guji,Adola Town,Yekatit,6,2010,36,70,60,166
Oromia,Jimma,Mancho,Ginbot,9,2010,65,35,28,128
Oromia,Bale,Agarfa,Hedar,3,2011,98,49,45,192
Oromia,Assela Town,Assela Town,Nehase,12,2010,79,44,1,124
Oromia,West Hararge,Doba,Yekatit,6,2011,23,33,74,130
Oromia,Shashamane Town,Shashamane Town,Miyazia,8,2010,98,54,77,229
Oromia,Buno Bedele,Boricha,Nehase,12,2009,50,40,69,159
Oromia,East Shewa,Boset,Ginbot,9,2011,88,47,43,178
Oromia,Guji,Adola Reda,Ginbot,9,2011,83,89,37,209
Oromia,West Shewa,Bako Tibe,Ginbot,9,2010,23,23,84,130
Oromia,South West Shewa,Becho,Miyazia,8,2009,90,17,35,142
Oromia,East Shewa,Adama,Tahesas,4,2010,10,38,10,58
Oromia,Guji,Girja,Tahesas,4,2011,67,99,4,170
Oromia,East Wellega,Diga,Megabit,7,2009,24,72,63,159
Oromia,Qeleme Wellega,Dale Sedi,Yekatit,6,2010,63,63,41,167
Oromia,West Shewa,Gojo Hospital,Teqemt,2,2010,42,13,98,153
Oromia,East Shewa,Matahara,Hamle,11,2009,20,4,67,91
Oromia,West Wellega,Mendi Town,Yekatit,6,2010,16,46,46,108
Oromia,Shashamane Town,Shashamane Town,Nehase,12,2010,60,41,35,136
Oromia,West Wellega,Gimbi Public  Hospital,Hamle,11,2009,42,79,9,130
Oromia,Gelan Town,Gelan Town,Teqemt,2,2011,71,92,53,216
Oromia,West Hararge,Meiso,Teqemt,2,2010,36,77,58,171
Oromia,South West Shewa,Seden Sodo,Hedar,3,2010,64,69,94,227
Oromia,Arsi,Shenan Kolu,Hamle,11,2010,44,74,4,122
Oromia,Arsi,Zeway Dugda,Miyazia,8,2011,51,15,87,153
Oromia,Jimma,Omo Nada Hospital,Tahesas,4,2011,57,53,84,194
Oromia,Lege Dadi Lege Tafo Town,Lege Dadi Lege Tafo Town,Megabit,7,2011,92,12,18,122
Oromia,Guji,Liben,Teqemt,2,2011,80,69,13,162
Oromia,East Wellega,Sasiga,Miyazia,8,2011,38,61,48,147
Oromia,East Wellega,Haro Limu,Nehase,12,2009,67,48,94,209
Oromia,North Shewa,Degem,Yekatit,6,2011,63,22,13,98
Oromia,East Shewa,Fentale,Ginbot,9,2010,1,98,15,114
Oromia,Ambo Town,Ambo Town,Yekatit,6,2011,75,80,9,164
Oromia,East Shewa,Gimbichu,Hamle,11,2010,33,32,1,66
Oromia,Qeleme Wellega,Sedan Chanka,Megabit,7,2011,34,84,93,211
Oromia,West Guji,Bule Hora Toun,Yekatit,6,2011,86,68,55,209
Oromia,South West Shewa,Ameya,Tahesas,4,2011,96,65,3,164
Oromia,Guji,Adola Reda,Meskerem,1,2010,44,22,51,117
Oromia,West Shewa,Jibat,Meskerem,1,2010,60,42,45,147
Oromia,Bale,Gololcha,Ginbot,9,2011,83,95,46,224
Oromia,Arsi,Enkelo Wabe,Nehase,12,2009,87,19,96,202
Oromia,Nekemte Town,Nekemte Town,Sene,10,2011,43,58,34,135
Oromia,East Hararge,Deder,Hedar,3,2011,80,26,59,165
Oromia,North Shewa,Yaya Gulele,Tir,5,2009,75,44,15,134
Oromia,West Arsi,Shashemene Rural,Meskerem,1,2010,41,24,80,145
Oromia,West Guji,Biebirsa Kojowa,Sene,10,2011,55,44,71,170
Oromia,North Shewa,Girar Jarso,Hamle,11,2009,92,34,8,134
Oromia,West Arsi,Loke Hada Hospital,Nehase,12,2010,65,48,12,125
Oromia,West Arsi,Hebal Arsi,Sene,10,2010,0,59,55,114
Oromia,North Shewa,Fichetown,Nehase,12,2009,36,76,66,178
Oromia,Qeleme Wellega,Sedan Chanka,Ginbot,9,2011,67,67,51,185
Oromia,West Guji,Dugda Dawa,Sene,10,2009,4,70,86,160
Oromia,Buno Bedele,Chora,Tir,5,2011,20,3,1,24
Oromia,Sululta Town,Sululta Town,Sene,10,2009,0,25,59,84
Oromia,East Shewa,Batu,Nehase,12,2009,48,9,42,99
Oromia,Borena,Dilo,Meskerem,1,2010,54,36,76,166
Oromia,West Arsi,Dodola  Hospital,Hamle,11,2010,22,12,44,78
Oromia,East Hararge,Fedis,Hamle,11,2010,17,15,73,105
Oromia,West Wellega,Gimbi Adventist Hospital,Miyazia,8,2010,17,2,11,30
Oromia,East Hararge,Goro Muti,Tir,5,2011,29,88,58,175
Oromia,East Hararge,Babile Woreda,Nehase,12,2009,38,0,47,85
Oromia,West Wellega,Boji Cheqorsa,Hedar,3,2010,84,41,11,136
Oromia,Buno Bedele,Diga,Tir,5,2009,58,90,39,187
Oromia,Jimma,Sigmo,Hedar,3,2011,9,43,13,65
Oromia,East Shewa,Matahara,Tahesas,4,2010,56,62,99,217
Oromia,West Wellega,Gimbi Public  Hospital,Hedar,3,2011,72,27,92,191
Oromia,North Shewa,Fichetown,Megabit,7,2009,17,14,24,55
Oromia,West Guji,Mkelka Soda,Hamle,11,2010,12,24,5,41
Oromia,Ilu Aba Bora,Ale,Sene,10,2010,61,31,86,178
Oromia,Arsi,Shirka,Megabit,7,2011,45,43,44,132
Oromia,West Hararge,Tulo,Miyazia,8,2010,77,56,85,218
Oromia,West Wellega,Mendi Hospital,Megabit,7,2010,87,98,82,267
Oromia,West Shewa,Bako Tibe,Tahesas,4,2011,61,91,73,225
Oromia,West Hararge,Habro,Tahesas,4,2010,28,47,1,76
Oromia,West Shewa,Bako Tibe,Hamle,11,2010,97,55,17,169
Oromia,Buno Bedele,Chora,Megabit,7,2009,94,99,58,251
Oromia,Guji,Adola Town,Sene,10,2009,43,87,91,221
Oromia,West Shewa,Bako Tibe,Miyazia,8,2009,57,72,23,152
Oromia,South West Shewa,Tulu Bolo Hospital,Teqemt,2,2010,31,18,73,122
Oromia,Finfine Zuria,Sandefa,Tahesas,4,2011,45,90,40,175
Oromia,Ilu Aba Bora,Doreni,Teqemt,2,2011,31,27,82,140
Oromia,Lege Dadi Lege Tafo Town,Lege Dadi Lege Tafo Town,Miyazia,8,2009,68,71,2,141
Oromia,Jimma,Limu Seka,Miyazia,8,2010,40,69,89,198
Oromia,Jimma,Mana,Yekatit,6,2009,32,12,97,141
Oromia,West Shewa,Jibat,Teqemt,2,2010,71,57,27,155
Oromia,West Arsi,Siraro,Tir,5,2011,14,34,20,68
Oromia,West Wellega,Boji Cheqorsa,Teqemt,2,2011,28,72,43,143
Oromia,Horo Gudru Wellega,Shambu Hospital,Nehase,12,2010,3,50,24,77
Oromia,Arsi,Seru,Megabit,7,2010,27,63,52,142
Oromia,South West Shewa,Becho,Tir,5,2011,73,18,98,189
Oromia,West Guji,Suro Barguda,Megabit,7,2011,43,93,36,172
Oromia,Jimma,Mancho,Ginbot,9,2011,44,16,17,77
Oromia,West Wellega,Mendi Hospital,Meskerem,1,2011,12,29,13,54
Oromia,West Wellega,Genji,Hamle,11,2010,22,35,63,120
Oromia,West Wellega,Boji Cheqorsa,Nehase,12,2009,28,71,14,113
Oromia,Borena,Guchi,Sene,10,2009,91,19,80,190
Oromia,East Hararge,Melka Belo,Hedar,3,2010,87,91,12,190
Oromia,Horo Gudru Wellega,Jima Rare,Hedar,3,2011,64,68,47,179
Oromia,Jimma,Gomma,Tir,5,2010,25,73,22,120
Oromia,West Guji,Mkelka Soda,Ginbot,9,2010,76,79,91,246
Oromia,Arsi,Dodota,Hamle,11,2009,58,21,55,134
Oromia,Jimma Spe Town,Jimma Spe Town,Megabit,7,2010,90,75,0,165
Oromia,Bale,Gololcha,Miyazia,8,2011,99,76,60,235
Oromia,East Shewa,Boset,Ginbot,9,2011,35,13,64,112
Oromia,West Shewa,Gojo Hospital,Meskerem,1,2010,56,12,35,103
Oromia,West Arsi,Wondo,Hamle,11,2009,36,50,99,185
Oromia,West Hararge,Doba,Meskerem,1,2011,40,83,51,174
Oromia,Finfine Zuria,Berreh,Nehase,12,2010,32,22,89,143
Oromia,Arsi,Enkelo Wabe,Sene,10,2009,66,32,77,175
Oromia,Robe Town,Robe Town,Hamle,11,2010,35,85,27,147
Oromia,Bale,Arena Buluq,Yekatit,6,2009,83,35,16,134
Oromia,Shashamane Town,Shashamane Town,Yekatit,6,2011,15,44,20,79
Oromia,East Hararge,Meta,Yekatit,6,2009,10,5,53,68
Oromia,Qeleme Wellega,Yemalogi Wolel,Tir,5,2010,77,91,88,256
Oromia,West Guji,Bule Hora,Tahesas,4,2010,98,64,33,195
Oromia,Borena,Dhas,Yekatit,6,2010,23,42,63,128
Oromia,Guji,Anna Sora,Miyazia,8,2011,31,8,74,113
Oromia,Qeleme Wellega,Sedan Chanka,Megabit,7,2011,13,59,94,166
Oromia,Ilu Aba Bora,Yayu,Tahesas,4,2011,72,36,95,203
Oromia,Arsi,Deksis,Nehase,12,2010,70,76,12,158
Oromia,Arsi,Tena,Nehase,12,2009,1,14,95,110
Oromia,West Hararge,Anchar,Megabit,7,2010,31,39,71,141
Oromia,Bale,Meda Welabu,Megabit,7,2009,87,28,29,144
Oromia,East Shewa,Lomme,Megabit,7,2009,34,33,40,107
Oromia,West Guji,Mkelka Soda,Hedar,3,2011,63,30,41,134
Oromia,Guji,Uraga,Miyazia,8,2011,98,23,0,121
Oromia,Bale,Dawe Qachen,Miyazia,8,2009,23,99,21,143
Oromia,South West Shewa,St.Luke Hospital,Tir,5,2011,54,9,86,149
Oromia,Arsi,Sire,Hamle,11,2010,90,6,71,167
Oromia,Borena,El Way,Sene,10,2009,92,19,35,146
Oromia,Bale,Goba Town,Megabit,7,2009,89,84,19,192
Oromia,South West Shewa,Seden Sodo,Teqemt,2,2010,59,18,43,120
Oromia,Jimma,Agaro Hospital,Hamle,11,2010,19,63,88,170
Oromia,Jimma,Gomma,Ginbot,9,2009,34,25,42,101
Oromia,Jimma,Dedo,Hedar,3,2011,17,74,28,119
Oromia,Bale,Meda Welabu,Tahesas,4,2011,32,40,53,125
Oromia,West Shewa,Tibe Kutaye,Sene,10,2010,98,99,40,237
Oromia,West Shewa,Ambo Hospital,Meskerem,1,2010,73,85,17,175
Oromia,West Hararge,Hawi Gudina,Meskerem,1,2010,3,68,98,169
Oromia,Ilu Aba Bora,Algesachi,Miyazia,8,2009,97,56,27,180
Oromia,West Hararge,Burka Dimtu,Nehase,12,2010,59,42,79,180
Oromia,West Arsi,Kore,Hamle,11,2009,70,64,43,177
Oromia,South West Shewa,Tole,Megabit,7,2009,7,74,16,97
Oromia,Finfine Zuria,Mullo,Ginbot,9,2011,50,11,33,94
Oromia,West Arsi,Dodola Rural,Nehase,12,2009,40,42,82,164
Oromia,Finfine Zuria,Sebeta Awas,Sene,10,2011,54,24,22,100
Oromia,Bale,Gasera,Tahesas,4,2010,40,3,96,139
Oromia,Jimma,Gomma,Tahesas,4,2011,50,46,26,122
Oromia,West Wellega,Lalo Asabi,Tahesas,4,2011,65,13,11,89
Oromia,East Hararge,Deder,Yekatit,6,2010,11,81,19,111
Oromia,Gelan Town,Gelan Town,Ginbot,9,2009,67,39,20,126
Oromia,East Hararge,Meyu Muleke,Megabit,7,2009,9,60,51,120
Oromia,West Hararge,Bedesa Town,Yekatit,6,2010,78,90,72,240
Oromia,West Hararge,Daro Lebu,Ginbot,9,2009,28,71,87,186
Oromia,South West Shewa,Sodo Dac'Ha,Sene,10,2011,7,31,18,56
Oromia,East Hararge,Midega Tole,Meskerem,1,2011,81,56,38,175
Oromia,North Shewa,Jido,Teqemt,2,2010,41,43,41,125
Oromia,Bale,Gololcha,Tir,5,2011,57,11,59,127
Oromia,Arsi,Limuna Bilbilo,Tir,5,2011,94,33,32,159
Oromia,East Hararge,Bisidimo Hospital,Tir,5,2011,74,19,26,119
Oromia,West Hararge,Chiro Hospital,Miyazia,8,2009,42,96,45,183
Oromia,West Arsi,Wondo,Megabit,7,2010,47,43,69,159
Oromia,Arsi,Bekoji Town,Teqemt,2,2011,36,49,69,154
Oromia,Borena,Moyale Hospital,Ginbot,9,2009,49,3,36,88
Oromia,East Wellega,Ebantu,Miyazia,8,2009,17,29,7,53
Oromia,Qeleme Wellega,Dambi Dollo,Hedar,3,2010,21,62,45,128
Oromia,West Hararge,Habro,Sene,10,2009,45,37,9,91
Oromia,West Hararge,Mesela,Megabit,7,2009,70,29,66,165
Oromia,West Wellega,Yubdo,Tahesas,4,2010,49,38,30,117
Oromia,West Shewa,Meta Waliqite,Megabit,7,2009,92,97,56,245
Oromia,West Wellega,Kundala,Megabit,7,2010,71,55,79,205
Oromia,South West Shewa,Tole,Megabit,7,2010,43,71,61,175
Oromia,West Hararge,Meiso,Sene,10,2010,55,28,93,176
Oromia,Bale,Raitu,Nehase,12,2010,57,57,66,180
Oromia,Arsi,Sude,Sene,10,2011,3,95,50,148
Oromia,North Shewa,Dera,Tahesas,4,2010,93,55,94,242
Oromia,Qeleme Wellega,Gidami,Nehase,12,2010,39,96,43,178
Oromia,Horo Gudru Wellega,Amuru,Sene,10,2009,19,98,23,140
Oromia,Qeleme Wellega,Hawa Gelan,Hedar,3,2010,53,35,7,95
Oromia,Horo Gudru Wellega,Horro Buluk,Miyazia,8,2011,41,26,38,105
Oromia,East Shewa,Fentale,Ginbot,9,2009,26,25,45,96
Oromia,West Guji,Kercha,Nehase,12,2010,41,85,8,134
Oromia,Arsi,Sire,Miyazia,8,2011,22,6,68,96
Oromia,West Guji,Mkelka Soda,Hedar,3,2011,47,0,32,79
Oromia,Qeleme Wellega,Sedan Chanka,Sene,10,2011,91,20,73,184
Oromia,West Guji,Kercha Hospital,Megabit,7,2010,72,8,83,163
Oromia,Borena,Teltele,Hedar,3,2011,58,85,49,192
Oromia,Jimma,Omonada,Hedar,3,2010,45,75,83,203
Oromia,South West Shewa,Kersana Malima,Megabit,7,2009,6,56,1,63
Oromia,West Wellega,Yubdo,Hamle,11,2010,99,86,62,247
Oromia,West Shewa,Codi,Tir,5,2010,71,58,45,174
Oromia,West Shewa,Dendi,Teqemt,2,2010,93,38,13,144
Oromia,Horo Gudru Wellega,Jima Rare,Tir,5,2010,7,24,58,89
Oromia,Arsi,Bekoji Town,Yekatit,6,2011,9,97,30,136
Oromia,South West Shewa,Ilu,Sene,10,2011,60,70,36,166
Oromia,West Wellega,Nejo Hospital,Megabit,7,2011,51,34,15,100
Oromia,West Guji,Dugda Dawa,Megabit,7,2009,6,87,1,94
Oromia,Qeleme Wellega,Gawo Qebe,Tahesas,4,2010,55,62,89,206
Oromia,North Shewa,Fiche Hospital,Hamle,11,2009,37,46,44,127
Oromia,North Shewa,Dera Hospital,Tir,5,2011,76,96,49,221
Oromia,Guji,Uraga,Hedar,3,2010,22,48,23,93
Oromia,East Hararge,Kurfa Chele,Tahesas,4,2011,47,38,18,103
Oromia,Bale,Ginir,Tir,5,2011,54,71,50,175
Oromia,West Wellega,Seyo Nole,Tir,5,2010,55,91,19,165
Oromia,West Hararge,Chiro Town,Meskerem,1,2010,90,82,22,194
Oromia,East Wellega,Nunu Qumba,Miyazia,8,2011,87,9,52,148
Oromia,West Guji,Kercha Hospital,Yekatit,6,2010,70,80,86,236
Oromia,Horo Gudru Wellega,Shambu Town,Yekatit,6,2009,66,20,25,111
Oromia,Bale,Seweyna,Tir,5,2011,48,70,28,146
Oromia,West Hararge,West Harerge	Gumbi Bordede,Ginbot,9,2010,34,12,84,130
Oromia,West Guji,Kercha,Megabit,7,2009,70,92,21,183
Oromia,Finfine Zuria,Akaki,Megabit,7,2009,42,77,71,190
Oromia,Jimma,O/Beyam,Tir,5,2011,39,8,40,87
Oromia,East Hararge,Melka Belo,Hamle,11,2009,48,41,39,128
Oromia,South West Shewa,Wonchi,Nehase,12,2010,69,23,64,156
Oromia,Bale,Arena Buluq,Hedar,3,2011,45,67,31,143
Oromia,Qeleme Wellega,Yemalogi Wolel,Hedar,3,2011,5,81,14,100
Oromia,Borena,Dubluk,Hedar,3,2010,25,66,34,125
Oromia,Horo Gudru Wellega,Horo,Tir,5,2009,61,18,80,159
Oromia,South West Shewa,Ameya,Tahesas,4,2011,55,93,72,220
Oromia,East Wellega,Ebantu,Tir,5,2009,1,65,84,150
Oromia,West Arsi,Dodola  Hospital,Tir,5,2011,53,47,6,106
Oromia,South West Shewa,St.Luke Hospital,Ginbot,9,2011,59,8,53,120
Oromia,East Hararge,Chelenko Hospital,Yekatit,6,2009,12,67,94,173
Oromia,West Hararge,Chiro Town,Tir,5,2011,35,20,94,149
Oromia,Ilu Aba Bora,Nono Sele,Nehase,12,2010,60,22,38,120
Oromia,North Shewa,Hidabu Abote,Yekatit,6,2010,17,56,82,155
Oromia,East Wellega,Gobu Seyo,Ginbot,9,2010,85,51,84,220
Oromia,Guji,Uraga,Megabit,7,2010,18,64,22,104
Oromia,North Shewa,Fiche Hospital,Tir,5,2011,93,49,47,189
Oromia,Arsi,Bekoji Town,Teqemt,2,2011,98,45,38,181
Oromia,East Hararge,Deder,Teqemt,2,2010,24,42,47,113
Oromia,West Arsi,Shala,Megabit,7,2011,68,8,12,88
Oromia,West Shewa,Jibat,Nehase,12,2010,57,17,90,164
Oromia,West Wellega,Nole Kaba,Yekatit,6,2009,41,22,66,129
Oromia,West Wellega,Boji Dermeji,Tahesas,4,2011,44,11,41,96
Oromia,East Shewa,Dugda,Sene,10,2011,98,60,26,184
Oromia,West Shewa,Chelia,Hamle,11,2009,68,41,82,191
Oromia,West Arsi,Adaba,Sene,10,2009,1,85,35,121
Oromia,Finfine Zuria,Sululta Town,Megabit,7,2011,3,38,63,104
Oromia,Ilu Aba Bora,Bilonopa,Ginbot,9,2010,5,71,28,104
Oromia,Borena,Yabelo Rural,Megabit,7,2011,28,7,45,80
Oromia,West Wellega,Boji Dermeji,Yekatit,6,2011,90,30,41,161
Oromia,Jimma,Limu Kosa,Miyazia,8,2010,9,87,71,167
Oromia,West Arsi,Dodola  Hospital,Sene,10,2011,48,93,27,168
Oromia,East Hararge,Meyu Muleke,Miyazia,8,2009,19,65,72,156
Oromia,Guji,Liben,Nehase,12,2009,33,85,80,198
Oromia,West Guji,Bule Hora Toun,Nehase,12,2009,5,38,15,58
Oromia,East Shewa,Liben,Ginbot,9,2009,56,57,61,174
Oromia,Borena,Dilo,Meskerem,1,2011,79,92,81,252
Oromia,West Shewa,Bako Hospital,Ginbot,9,2011,93,25,93,211
Oromia,Arsi,Amigna,Megabit,7,2009,33,35,87,155
Oromia,Holeta Town,Holeta Town,Sene,10,2011,49,32,53,134
Oromia,West Shewa,Ginde Beret,Nehase,12,2009,69,6,51,126
Oromia,Finfine Zuria,Sululta Town,Miyazia,8,2011,26,96,36,158
Oromia,East Hararge,Haromaya Rural,Sene,10,2010,73,20,75,168
Oromia,East Hararge,Meyu Muleke,Hedar,3,2011,6,89,13,108
Oromia,Jimma,Seka Chekorsa,Sene,10,2009,24,13,72,109
Oromia,Guji,Goro Dola,Nehase,12,2010,64,14,70,148
Oromia,Horo Gudru Wellega,Amuru,Tir,5,2010,43,57,14,114
Oromia,Sululta Town,Sululta Town,Megabit,7,2009,68,0,54,122
Oromia,East Wellega,Sasiga,Miyazia,8,2009,84,79,87,250
Oromia,Guji,Dima,Tahesas,4,2011,18,13,10,41
Oromia,Jimma,Chora Boter,Ginbot,9,2009,27,36,43,106
Oromia,West Arsi,Dodola Rural,Sene,10,2010,54,67,86,207
Oromia,Borena,Guchi,Teqemt,2,2011,62,19,85,166
Oromia,West Shewa,Liban Jawi,Miyazia,8,2009,55,91,94,240
Oromia,Guji,Aga Wayyu,Ginbot,9,2011,22,63,9,94
Oromia,West Arsi,Nensebo,Megabit,7,2009,35,36,37,108
Oromia,West Wellega,Lalo Asabi,Hedar,3,2010,73,19,21,113
Oromia,North Shewa,Yaya Gulele,Hedar,3,2010,9,7,75,91
Oromia,Borena,Yabelo Rural,Sene,10,2010,80,23,97,200
Oromia,Jimma,Limu Seka,Hedar,3,2011,54,28,34,116
Oromia,Jimma,Setema,Meskerem,1,2011,91,21,17,129
Oromia,West Arsi,Arsi Negele Town,Ginbot,9,2010,50,29,10,89
Oromia,Jimma,Seka Chekorsa,Megabit,7,2011,76,55,0,131
Oromia,West Hararge,Chiro Town,Nehase,12,2010,21,17,22,60
Oromia,West Shewa,Bako Tibe,Teqemt,2,2011,81,35,89,205
Oromia,West Arsi,Adaba,Sene,10,2010,78,90,89,257
Oromia,West Hararge,Boke,Tahesas,4,2010,95,99,96,290
Oromia,Finfine Zuria,Walmera,Ginbot,9,2010,78,25,37,140
Oromia,West Arsi,Arsi Negele Town,Teqemt,2,2010,41,8,73,122
Oromia,East Wellega,Gida Ayana,Yekatit,6,2010,22,91,91,204
Oromia,East Hararge,Melka Belo,Nehase,12,2009,12,83,78,173
Oromia,Jimma,Sigmo,Yekatit,6,2010,36,7,67,110
Oromia,Finfine Zuria,Holeta,Tir,5,2009,22,61,13,96
Oromia,West Hararge,Chiro Zuriya,Tahesas,4,2010,22,3,34,59
Oromia,East Hararge,Midega Tole,Sene,10,2010,42,24,63,129
Oromia,Guji,Bore,Tahesas,4,2010,37,94,34,165
Oromia,North Shewa,Dera Hospital,Teqemt,2,2010,77,64,11,152
Oromia,West Guji,Bule Hora Toun,Tahesas,4,2011,39,1,4,44
Oromia,Borena,Moyale,Hedar,3,2011,41,83,4,128
Oromia,Woliso Town,Woliso Town,Yekatit,6,2010,15,20,61,96
Oromia,West Wellega,Boji Dermeji,Yekatit,6,2009,34,10,11,55
Oromia,West Wellega,Boji Cheqorsa,Teqemt,2,2010,4,72,83,159
Oromia,West Hararge,Oda Bultum,Miyazia,8,2009,94,85,3,182
Oromia,Holeta Town,Holeta Town,Miyazia,8,2011,73,86,7,166
Oromia,West Hararge,Chiro Town,Tir,5,2009,73,70,2,145
Oromia,West Wellega,Mene Sibu,Ginbot,9,2009,8,69,92,169
Oromia,West Shewa,Adea Berga,Miyazia,8,2009,43,34,39,116
Oromia,East Hararge,Kurfa Chele,Hamle,11,2009,12,64,82,158
Oromia,West Wellega,Yubdo,Tir,5,2011,62,72,52,186
Oromia,Arsi,Hitosa,Ginbot,9,2010,12,84,66,162
Oromia,West Wellega,Nejo Hospital,Hamle,11,2010,84,9,70,163
Oromia,Buno Bedele,Bedele Zuriya,Sene,10,2011,55,70,48,173
Oromia,Guji,Uraga,Tahesas,4,2010,56,75,26,157
Oromia,Arsi,Bekoji Town,Tahesas,4,2011,91,91,72,254
Oromia,West Hararge,Chiro Town,Tahesas,4,2011,60,5,14,79
Oromia,Guji,Dima,Miyazia,8,2011,97,42,70,209
Oromia,East Hararge,Deder Town,Tir,5,2010,33,61,79,173
Oromia,West Hararge,Mesela,Miyazia,8,2010,28,22,67,117
Oromia,North Shewa,Fichetown,Ginbot,9,2009,66,83,24,173
Oromia,West Wellega,Genji,Yekatit,6,2011,13,25,1,39
Oromia,Bale,Gololcha,Hamle,11,2010,42,82,10,134
Oromia,West Wellega,Boji Dermeji,Hamle,11,2009,52,59,32,143
Oromia,East Hararge,Fedis,Megabit,7,2011,25,93,69,187
Oromia,West Shewa,Jeldu,Ginbot,9,2011,67,90,21,178
Oromia,North Shewa,Degem,Sene,10,2009,27,10,4,41
Oromia,Arsi,Limuna Bilbilo,Megabit,7,2010,29,22,42,93
Oromia,West Shewa,Bako Tibe,Sene,10,2009,43,30,24,97
Oromia,West Wellega,Haru,Hedar,3,2011,63,81,21,165
Oromia,West Hararge,Burka Dimtu,Hedar,3,2011,76,26,8,110
Oromia,Arsi,Munesa,Nehase,12,2009,20,11,68,99
Oromia,North Shewa,Kuyu,Megabit,7,2009,6,74,28,108
Oromia,Bale,Dawe Qachen,Sene,10,2010,36,64,26,126
Oromia,West Wellega,Gimbi Rural,Miyazia,8,2011,44,76,28,148
Oromia,East Hararge,Deder Town,Ginbot,9,2009,54,31,75,160
Oromia,East Hararge,Haromaya Town,Hamle,11,2010,87,69,40,196
Oromia,Buno Bedele,Chora,Miyazia,8,2009,11,94,26,131
Oromia,Horo Gudru Wellega,Jarte Jardga,Megabit,7,2009,64,91,9,164
Oromia,Arsi,Gololcha,Tahesas,4,2011,35,23,12,70
Oromia,Horo Gudru Wellega,Jima Geneti,Hamle,11,2009,39,13,97,149
Oromia,Horo Gudru Wellega,Shambu Town,Megabit,7,2010,38,89,79,206
Oromia,West Hararge,Guba Qoricha,Hedar,3,2011,8,5,78,91
Oromia,Borena,Yabelo Rural,Ginbot,9,2010,24,16,45,85
Oromia,Arsi,Shirka,Miyazia,8,2009,76,91,16,183
Oromia,Dukem Town,Dukem Town,Meskerem,1,2011,7,97,97,201
Oromia,Arsi,Aseko,Megabit,7,2010,83,66,23,172
Oromia,Borena,Moyale,Hedar,3,2010,30,4,30,64
Oromia,East Hararge,Haromaya Hospital,Megabit,7,2009,0,83,22,105
Oromia,North Shewa,Wuchale,Tir,5,2009,32,25,37,94
Oromia,West Arsi,Gedeb Asasa,Teqemt,2,2011,38,47,67,152
Oromia,Arsi,Sire,Nehase,12,2009,30,30,68,128
Oromia,West Shewa,Ejerie,Tahesas,4,2010,86,19,87,192
Oromia,Adama Special Town,Adama Town,Meskerem,1,2011,5,65,45,115
Oromia,Guji,Shakiso Town,Yekatit,6,2010,28,78,0,106
Oromia,Bale,Dawe Qachen,Tir,5,2011,62,49,63,174
Oromia,West Hararge,Tulo,Megabit,7,2010,89,37,4,130
Oromia,Arsi,Digeluna Tijo,Teqemt,2,2010,16,88,69,173
Oromia,Horo Gudru Wellega,Horo,Nehase,12,2010,37,79,70,186
Oromia,Bale,Ginir,Teqemt,2,2010,88,93,86,267
Oromia,West Arsi,Arsi Negele Town,Nehase,12,2009,43,44,84,171
Oromia,South West Shewa,Tole,Hamle,11,2010,2,29,94,125
Oromia,Arsi,Hitosa,Ginbot,9,2010,9,36,23,68
Oromia,North Shewa,Fiche Hospital,Megabit,7,2010,7,49,89,145
Oromia,Ilu Aba Bora,Doreni,Ginbot,9,2009,76,31,1,108
Oromia,West Hararge,Boke,Meskerem,1,2010,6,32,83,121
Oromia,Borena,Arero,Ginbot,9,2010,90,76,49,215
Oromia,Bale,Dawe Qachen,Meskerem,1,2011,21,31,52,104
Oromia,Arsi,Gololcha,Nehase,12,2009,51,28,66,145
Oromia,North Shewa,Dera Hospital,Hamle,11,2010,65,2,31,98
Oromia,Arsi,Digeluna Tijo,Ginbot,9,2011,32,77,54,163
Oromia,Finfine Zuria,Sululta Town,Yekatit,6,2010,87,42,4,133
Oromia,Arsi,Sire,Tahesas,4,2011,44,76,5,125
Oromia,West Wellega,Seyo Nole,Tir,5,2011,63,83,72,218
Oromia,Guji,Uraga,Hamle,11,2009,73,35,20,128
Oromia,West Arsi,Dodola  Hospital,Miyazia,8,2010,87,13,12,112
Oromia,West Arsi,Dodola Town,Ginbot,9,2011,56,46,54,156
Oromia,Qeleme Wellega,Anfilo,Ginbot,9,2009,22,33,18,73
Oromia,Arsi,Gololcha,Hedar,3,2010,81,64,11,156
Oromia,North Shewa,Dera,Meskerem,1,2011,48,84,95,227
Oromia,Arsi,Zeway Dugda,Hamle,11,2010,45,89,32,166
Oromia,West Wellega,Nole Kaba,Megabit,7,2011,84,17,49,150
Oromia,North Shewa,Abichugna,Yekatit,6,2010,91,34,80,205
Oromia,Guji,Adola Town,Hedar,3,2011,8,81,15,104
Oromia,West Wellega,Begi,Meskerem,1,2010,68,47,7,122
Oromia,Ilu Aba Bora,Metu Town,Hamle,11,2009,34,28,80,142
Oromia,Horo Gudru Wellega,Horro Buluk,Teqemt,2,2011,51,79,3,133
Oromia,East Wellega,Boneya Bushe,Megabit,7,2009,43,44,29,116
Oromia,West Shewa,Ambo Hospital,Megabit,7,2009,57,34,77,168
Oromia,West Wellega,Haru,Sene,10,2009,42,6,48,96
Oromia,Arsi,Bekoji Town,Tir,5,2009,15,72,44,131
Oromia,Jimma,Guma,Ginbot,9,2010,24,47,28,99
Oromia,Borena,Yabelo,Nehase,12,2010,16,30,31,77
Oromia,Arsi,Guna,Tir,5,2010,53,80,66,199
Oromia,Jimma,Dedo,Sene,10,2009,57,4,39,100
Oromia,Bale,Gololcha,Meskerem,1,2010,16,24,17,57
Oromia,Borena,Dilo,Nehase,12,2009,25,98,35,158
Oromia,West Shewa,Gindeberet Hospital,Sene,10,2011,91,44,12,147
Oromia,West Arsi,Dodola Rural,Sene,10,2011,80,65,49,194
Oromia,Horo Gudru Wellega,Hababo Guduru,Nehase,12,2010,16,85,37,138
Oromia,Gelan Town,Gelan Town,Miyazia,8,2011,3,15,37,55
Oromia,East Hararge,Deder Hospital,Ginbot,9,2009,15,25,63,103
Oromia,Arsi,Sire,Tir,5,2010,31,68,40,139
Oromia,South West Shewa,Goro,Hedar,3,2011,24,93,24,141
Oromia,Arsi,Deksis,Tir,5,2009,34,20,80,134
Oromia,Guji,Saba Boru,Ginbot,9,2010,53,70,52,175
Oromia,West Wellega,Babo Gembel,Yekatit,6,2009,27,85,98,210
Oromia,South West Shewa,Wonchi,Yekatit,6,2009,55,10,92,157
Oromia,West Shewa,Tikur Enchini,Meskerem,1,2010,89,26,67,182
Oromia,North Shewa,Debre Libanos,Tir,5,2011,51,48,59,158
Oromia,Finfine Zuria,Sululta Town,Tir,5,2009,92,6,5,103
Oromia,West Shewa,Tikur Enchini,Sene,10,2010,30,67,64,161
Oromia,East Hararge,Kumbi,Ginbot,9,2011,44,7,31,82
Oromia,East Hararge,Haromaya Rural,Sene,10,2011,12,41,99,152
Oromia,West Wellega,Gimbi Adventist Hospital,Tahesas,4,2010,69,64,23,156
Oromia,East Shewa,Adea,Teqemt,2,2011,33,92,78,203
Oromia,West Wellega,Guliso,Yekatit,6,2011,58,75,31,164
Oromia,West Shewa,Ejerie,Tir,5,2011,54,5,37,96
Oromia,Jimma,Nono Benja,Miyazia,8,2010,44,99,42,185
Oromia,Guji,Saba Boru,Megabit,7,2009,63,6,22,91
Oromia,East Shewa,Olanciti Hospital,Yekatit,6,2009,89,49,44,182
Oromia,Ilu Aba Bora,Yayu,Ginbot,9,2010,75,50,15,140
Oromia,Horo Gudru Wellega,Shambu Town,Hamle,11,2010,68,36,33,137
Oromia,Guji,Girja,Hamle,11,2009,95,2,40,137
Oromia,West Shewa,Tibe Kutaye,Tir,5,2010,73,14,76,163
Oromia,Qeleme Wellega,Hawa Gelan,Yekatit,6,2010,70,57,63,190
Oromia,West Wellega,Kundala,Megabit,7,2011,61,30,60,151
Oromia,East Wellega,Kiremu,Tir,5,2011,57,80,76,213
Oromia,Bale,Dawe Qachen,Sene,10,2009,56,12,95,163
Oromia,West Wellega,Jarso,Ginbot,9,2011,53,12,0,65
Oromia,West Guji,Gelana,Megabit,7,2009,63,22,58,143
Oromia,Buno Bedele,Bedele Hospital,Nehase,12,2010,22,2,9,33
Oromia,East Hararge,Kombolicha,Tahesas,4,2011,4,87,15,106
Oromia,Bale,Sinana,Ginbot,9,2009,76,0,41,117
Oromia,Adama Special Town,Adama Town,Yekatit,6,2009,65,17,99,181
Oromia,Guji,Adola Town,Ginbot,9,2010,80,75,24,179
Oromia,West Hararge,West Harerge	Gumbi Bordede,Yekatit,6,2011,41,12,82,135
Oromia,Buno Bedele,Gechi,Nehase,12,2010,44,8,62,114
Oromia,North Shewa,Aleiltu,Ginbot,9,2009,78,87,32,197
Oromia,Bale,Goba,Megabit,7,2010,12,68,68,148
Oromia,West Shewa,Dendi,Nehase,12,2009,83,95,71,249
Oromia,East Hararge,Meta,Miyazia,8,2009,88,50,80,218
Oromia,West Guji,Kercha Hospital,Miyazia,8,2010,69,33,0,102
Oromia,Arsi,Tena,Hamle,11,2010,15,67,5,87
Oromia,East Hararge,Meyu Muleke,Miyazia,8,2009,9,19,79,107
Oromia,North Shewa,Wuchale,Ginbot,9,2011,93,78,97,268
Oromia,Guji,Wadara,Yekatit,6,2009,2,87,7,96
Oromia,Arsi,Dodota,Yekatit,6,2010,64,79,24,167
Oromia,East Hararge,Babile,Meskerem,1,2010,19,57,20,96
Oromia,West Wellega,Nejo Town,Miyazia,8,2009,16,11,63,90
Oromia,West Shewa,Bako Hospital,Sene,10,2011,44,43,47,134
Oromia,Arsi,Shirka,Hedar,3,2010,33,25,8,66
Oromia,Borena,Dubluk,Sene,10,2010,16,13,29,58
Oromia,East Wellega,Haro Limu,Tahesas,4,2011,78,4,67,149
Oromia,Arsi,Guna,Megabit,7,2009,40,17,19,76
Oromia,South West Shewa,Sodo Dac'Ha,Hedar,3,2010,60,73,0,133
Oromia,Guji,Wadara,Ginbot,9,2011,54,70,94,218
Oromia,Bale,Gasera,Megabit,7,2009,72,73,17,162
Oromia,West Wellega,Genji,Megabit,7,2011,59,39,79,177
Oromia,Ilu Aba Bora,Metu Rural,Tir,5,2011,64,93,6,163
Oromia,West Hararge,Meiso,Hamle,11,2009,13,51,25,89
Oromia,West Hararge,Daro Lebu,Yekatit,6,2010,71,56,14,141
Oromia,Arsi,Chole,Sene,10,2011,40,10,61,111
Oromia,South West Shewa,Seden Sodo,Yekatit,6,2010,61,14,60,135
Oromia,West Shewa,Abuna Gindeberet,Miyazia,8,2011,60,51,45,156
Oromia,Jimma,Kersa,Nehase,12,2010,91,77,85,253
Oromia,Ilu Aba Bora,Halu,Megabit,7,2010,8,94,77,179
Oromia,Ilu Aba Bora,Ale,Ginbot,9,2011,52,21,66,139
Oromia,West Shewa,Jibat,Meskerem,1,2010,15,15,57,87
Oromia,South West Shewa,Dawo,Nehase,12,2009,45,10,85,140
Oromia,Ilu Aba Bora,Bure,Tir,5,2011,91,0,1,92
Oromia,Guji,Aga Wayyu,Ginbot,9,2011,82,90,67,239
Oromia,Arsi,Tena,Yekatit,6,2011,98,85,16,199
Oromia,Jimma,Guma,Ginbot,9,2009,26,98,81,205
Oromia,West Guji,Dugda Dawa,Meskerem,1,2010,22,30,58,110
Oromia,Arsi,Chole,Tahesas,4,2010,34,32,65,131
Oromia,West Wellega,Lata Sibu,Nehase,12,2010,62,68,64,194
Oromia,Jimma,Dedo,Sene,10,2011,55,61,0,116
Oromia,South West Shewa,Seden Sodo,Meskerem,1,2010,36,93,67,196
Oromia,West Hararge,Bedesa Town,Hedar,3,2011,15,23,3,41
Oromia,North Shewa,Abichugna,Sene,10,2010,27,72,39,138
Oromia,East Wellega,Limu,Megabit,7,2009,49,49,74,172
Oromia,West Shewa,Meta Waliqite,Tir,5,2011,48,80,97,225
Oromia,West Arsi,Hebal Arsi,Megabit,7,2011,27,2,67,96
Oromia,South West Shewa,Woliso Rural,Tahesas,4,2011,86,94,21,201
Oromia,West Shewa,Ambo Hospital,Miyazia,8,2011,1,86,85,172
Oromia,West Arsi,Hebal Arsi,Miyazia,8,2009,24,76,16,116
Oromia,Jimma,O/Beyam,Hamle,11,2010,68,21,68,157
Oromia,North Shewa,Debre Libanos,Tir,5,2010,32,78,3,113
Oromia,East Wellega,Gida Ayana,Teqemt,2,2010,57,58,8,123
Oromia,East Hararge,Kurfa Chele,Meskerem,1,2011,68,8,45,121
Oromia,Bale,Raitu,Meskerem,1,2010,15,62,73,150
Oromia,West Shewa,Nono,Megabit,7,2011,8,72,72,152
Oromia,Borena,Wachile,Tir,5,2011,40,35,71,146
Oromia,West Arsi,Bishan Guracha Town,Miyazia,8,2011,94,81,64,239
Oromia,Bale,Raitu,Nehase,12,2009,62,65,15,142
Oromia,West Wellega,Nole Kaba,Nehase,12,2010,70,0,73,143
Oromia,East Shewa,Fentale,Miyazia,8,2011,32,72,12,116
Oromia,East Hararge,Deder,Ginbot,9,2009,14,36,86,136
Oromia,West Wellega,Nejo Hospital,Tir,5,2009,74,19,5,98
Oromia,West Shewa,Dano,Megabit,7,2009,44,83,24,151
Oromia,Arsi,Bale Gesgara,Tir,5,2011,9,58,75,142
Oromia,West Guji,Bule Hora Hospital,Hamle,11,2009,16,76,11,103
Oromia,West Shewa,Inchini Hospital,Hedar,3,2011,41,80,41,162
Oromia,Jimma,Seka Chekorsa,Megabit,7,2010,87,70,83,240
Oromia,Borena,Dilo,Yekatit,6,2009,84,57,86,227
Oromia,East Shewa,Bora,Miyazia,8,2010,75,82,81,238
Oromia,Guji,Wadara,Teqemt,2,2011,52,21,18,91
Oromia,Qeleme Wellega,Laloqile,Nehase,12,2009,50,77,89,216
Oromia,Horo Gudru Wellega,Jima Geneti,Ginbot,9,2011,8,51,36,95
Oromia,West Wellega,Guliso,Ginbot,9,2011,86,99,30,215
Oromia,West Shewa,Tibe Kutaye,Ginbot,9,2009,86,63,45,194
Oromia,North Shewa,Yaya Gulele,Megabit,7,2009,21,91,26,138
Oromia,Borena,Meyo,Miyazia,8,2009,33,11,33,77
Oromia,West Shewa,Tikur Enchini,Hedar,3,2010,15,12,18,45
Oromia,Finfine Zuria,Akaki,Ginbot,9,2009,96,61,36,193
Oromia,Bale,Arena Buluq,Yekatit,6,2011,27,39,15,81
Oromia,West Hararge,Boke,Nehase,12,2010,18,66,91,175
Oromia,Bale,Goba,Yekatit,6,2011,59,60,22,141
Oromia,East Wellega,Gudeyabila,Hedar,3,2010,27,26,15,68
Oromia,Borena,Dilo,Hedar,3,2010,32,25,18,75
Oromia,Jimma,Guma,Ginbot,9,2011,40,40,3,83
Oromia,Ilu Aba Bora,Bilonopa,Teqemt,2,2010,26,65,16,107
Oromia,West Shewa,Jibat,Tahesas,4,2010,81,60,70,211
Oromia,West Wellega,Mendi Town,Ginbot,9,2009,93,74,98,265
Oromia,West Shewa,Bako Tibe,Megabit,7,2011,39,71,29,139
Oromia,Arsi,Limuna Bilbilo,Nehase,12,2010,4,46,65,115
Oromia,East Shewa,Boset,Miyazia,8,2009,14,72,99,185
Oromia,Borena,Dhas,Miyazia,8,2011,82,82,95,259
Oromia,West Shewa,Abuna Gindeberet,Tir,5,2011,4,43,53,100
Oromia,East Hararge,Gursum,Yekatit,6,2011,98,37,80,215
Oromia,Lege Dadi Lege Tafo Town,Lege Dadi Lege Tafo Town,Megabit,7,2009,82,0,42,124
Oromia,Jimma,Sigmo,Teqemt,2,2010,72,29,85,186
Oromia,West Shewa,Dano,Tir,5,2011,32,2,65,99
Oromia,Ilu Aba Bora,Hurumu,Hedar,3,2010,39,88,16,143
Oromia,West Wellega,Mendi Hospital,Miyazia,8,2011,78,78,54,210
Oromia,Modjo Town,Modjo Town,Hedar,3,2010,34,58,80,172
Oromia,West Guji,Mkelka Soda,Miyazia,8,2011,98,40,9,147
Oromia,West Shewa,Adea Berga,Megabit,7,2009,71,57,77,205
Oromia,West Guji,Mkelka Soda,Nehase,12,2010,46,11,38,95
Oromia,Borena,Moyale Hospital,Ginbot,9,2011,22,48,40,110
Oromia,Horo Gudru Wellega,Jarte Jardga,Tir,5,2009,88,99,26,213
Oromia,Qeleme Wellega,Yemalogi Wolel,Yekatit,6,2011,90,35,23,148
Oromia,West Wellega,Gimbi Adventist Hospital,Sene,10,2010,4,20,82,106
Oromia,North Shewa,Abichugna,Hedar,3,2010,73,75,75,223
Oromia,Guji,Bore,Hamle,11,2010,93,10,18,121
Oromia,Arsi,Munesa,Yekatit,6,2010,20,62,8,90
Oromia,West Arsi,Dodola Rural,Ginbot,9,2011,29,23,84,136
Oromia,Jimma,Omo Nada Hospital,Nehase,12,2010,33,65,86,184
Oromia,Ilu Aba Bora,Metu Rural,Ginbot,9,2010,54,99,21,174
Oromia,Lege Dadi Lege Tafo Town,Lege Dadi Lege Tafo Town,Meskerem,1,2011,97,78,26,201
Oromia,North Shewa,Jido,Hedar,3,2010,30,71,13,114
Oromia,Bale,Gura Dhamole,Sene,10,2009,43,55,28,126
Oromia,Qeleme Wellega,Jimma Horo,Ginbot,9,2009,78,36,92,206
Oromia,South West Shewa,Goro,Tir,5,2011,35,71,18,124
Oromia,West Shewa,Jeldu,Hedar,3,2010,73,10,12,95
Oromia,West Arsi,Adaba,Nehase,12,2009,53,23,7,83
Oromia,Borena,Yabelo Rural,Nehase,12,2009,12,2,45,59
Oromia,Guji,Saba Boru,Hamle,11,2010,56,44,3,103
Oromia,East Hararge,Aweday Town,Megabit,7,2010,17,57,54,128
Oromia,East Hararge,Goro Gutu,Megabit,7,2009,81,31,23,135
Oromia,South West Shewa,Dawo,Tahesas,4,2011,44,29,5,78
Oromia,East Hararge,Haromaya Hospital,Ginbot,9,2010,12,74,27,113
Oromia,West Hararge,Chiro Zuriya,Sene,10,2011,22,20,19,61
Oromia,Buno Bedele,Boricha,Meskerem,1,2011,98,41,97,236
Oromia,East Hararge,Kumbi,Sene,10,2011,49,62,85,196
Oromia,West Shewa,Jeldu,Miyazia,8,2010,0,28,50,78
Oromia,Jimma,Mana,Hamle,11,2009,25,35,70,130
Oromia,East Wellega,Kiremu,Tir,5,2010,26,50,27,103
Oromia,North Shewa,Kimbibit,Yekatit,6,2009,47,53,97,197
Oromia,North Shewa,Fichetown,Tahesas,4,2011,87,82,77,246
Oromia,Jimma,Gomma,Tir,5,2010,5,91,46,142
Oromia,Bale,Delo Mena,Megabit,7,2011,64,74,89,227
Oromia,West Wellega,Ayira,Sene,10,2011,58,84,24,166
Oromia,East Hararge,Goro Gutu,Meskerem,1,2010,46,23,86,155
Oromia,Qeleme Wellega,Gawo Qebe,Miyazia,8,2010,75,57,45,177
Oromia,Arsi,Digeluna Tijo,Ginbot,9,2010,92,51,5,148
Oromia,Bale,Meda Welabu,Teqemt,2,2011,15,95,42,152
Oromia,Borena,El Way,Ginbot,9,2009,62,27,59,148
Oromia,West Arsi,Kofele,Ginbot,9,2011,16,23,20,59
Oromia,West Arsi,Kofele,Sene,10,2009,74,74,23,171
Oromia,West Arsi,Kore,Tir,5,2010,32,28,3,63
Oromia,Borena,Teltele,Megabit,7,2011,78,84,60,222
Oromia,North Shewa,Degem,Hamle,11,2010,62,1,36,99
Oromia,East Hararge,Melka Belo,Tir,5,2009,82,45,53,180
Oromia,West Guji,Hanbala,Nehase,12,2010,76,6,26,108
Oromia,Ilu Aba Bora,Metu Town,Meskerem,1,2011,67,41,66,174
Oromia,Bale,Dawe Qachen,Sene,10,2011,44,18,73,135
Oromia,Guji,Goro Dola,Miyazia,8,2009,74,88,51,213
Oromia,East Shewa,Dugda,Tir,5,2011,16,39,37,92
Oromia,Qeleme Wellega,Sedan Chanka,Yekatit,6,2011,61,58,3,122
Oromia,Qeleme Wellega,Anfilo,Miyazia,8,2011,32,42,30,104
Oromia,South West Shewa,St.Luke Hospital,Nehase,12,2009,64,45,46,155
Oromia,West Guji,Suro Barguda,Ginbot,9,2011,23,25,71,119
Oromia,Jimma,Limu Kosa,Yekatit,6,2009,13,78,99,190
Oromia,West Hararge,Gemechis,Nehase,12,2010,13,1,12,26
Oromia,West Arsi,Siraro,Teqemt,2,2010,52,26,15,93
Oromia,North Shewa,Kuyu Hospital,Nehase,12,2010,39,7,5,51
Oromia,Bale,Berbere,Ginbot,9,2011,77,26,40,143
Oromia,South West Shewa,Dawo,Tahesas,4,2011,6,62,44,112
Oromia,Guji,Odo Shakiso,Teqemt,2,2010,80,68,50,198
Oromia,Adama Special Town,Adama Town,Tahesas,4,2011,4,1,48,53
Oromia,West Wellega,Ayira,Nehase,12,2010,56,18,97,171
Oromia,Qeleme Wellega,Gawo Qebe,Nehase,12,2010,1,8,55,64
Oromia,West Shewa,Ambo Town,Sene,10,2009,7,93,18,118
Oromia,West Wellega,Gimbi Adventist Hospital,Sene,10,2009,55,70,54,179
Oromia,Ilu Aba Bora,Ale,Miyazia,8,2010,69,46,31,146
Oromia,East Hararge,Haromaya Rural,Ginbot,9,2009,6,10,27,43
Oromia,Qeleme Wellega,Yemalogi Wolel,Nehase,12,2009,77,55,51,183
Oromia,Bale,Gasera,Hedar,3,2010,38,93,90,221
Oromia,West Wellega,Nejo Rural,Teqemt,2,2010,98,56,38,192
Oromia,Borena,El Way,Yekatit,6,2011,8,27,12,47
Oromia,West Wellega,Mene Sibu,Hamle,11,2010,20,15,34,69
Oromia,West Arsi,Kofele,Ginbot,9,2009,8,44,99,151
Oromia,Buno Bedele,Boricha,Yekatit,6,2010,38,87,32,157
Oromia,Arsi,Robe,Hamle,11,2009,7,56,29,92
Oromia,Arsi,Gololcha,Ginbot,9,2011,85,97,10,192
Oromia,East Wellega,Gobu Seyo,Miyazia,8,2009,93,8,77,178
Oromia,West Shewa,Gojo Hospital,Hedar,3,2011,1,52,91,144
Oromia,West Shewa,Liban Jawi,Tir,5,2009,57,30,45,132
Oromia,Arsi,Limuna Bilbilo,Hamle,11,2009,10,84,80,174
Oromia,East Wellega,Nunu Qumba,Teqemt,2,2010,67,53,52,172
Oromia,Ilu Aba Bora,Yayu,Hedar,3,2010,52,3,65,120
Oromia,Finfine Zuria,Sandefa,Yekatit,6,2010,46,93,18,157
Oromia,Ilu Aba Bora,Becho,Megabit,7,2010,80,94,70,244
Oromia,West Wellega,Mendi Hospital,Tahesas,4,2010,69,68,7,144
Oromia,West Arsi,Adaba,Nehase,12,2009,96,80,95,271
Oromia,Borena,Dhas,Sene,10,2011,39,50,91,180
Oromia,Gelan Town,Gelan Town,Megabit,7,2011,34,89,55,178
Oromia,South West Shewa,Tole,Meskerem,1,2010,6,26,83,115
Oromia,East Wellega,Haro Limu,Yekatit,6,2009,18,76,31,125
Oromia,East Wellega,Sibu Sire,Yekatit,6,2009,76,25,90,191
Oromia,Finfine Zuria,Akaki,Yekatit,6,2010,62,77,51,190
Oromia,East Hararge,Haromaya Rural,Sene,10,2011,6,81,92,179
Oromia,Guji,Liben,Tahesas,4,2011,27,95,34,156
Oromia,West Wellega,Boji Dermeji,Hamle,11,2009,51,75,57,183
Oromia,East Hararge,Melka Belo,Tir,5,2011,92,37,94,223
Oromia,West Hararge,Hawi Gudina,Hamle,11,2009,5,56,71,132
Oromia,Guji,Negele Town,Sene,10,2010,34,34,8,76
Oromia,West Arsi,Arsi Negele Town,Megabit,7,2009,24,48,66,138
Oromia,Ilu Aba Bora,Bilonopa,Megabit,7,2010,15,19,89,123
Oromia,East Hararge,Chelenko Hospital,Megabit,7,2010,29,98,69,196
Oromia,North Shewa,Wuchale,Hamle,11,2010,73,34,69,176
Oromia,West Hararge,Bedesa Town,Ginbot,9,2011,78,32,79,189
Oromia,East Wellega,Gida Ayana,Sene,10,2011,6,85,20,111
Oromia,West Shewa,Gojo Hospital,Teqemt,2,2010,61,39,49,149
Oromia,West Arsi,Bishan Guracha Town,Sene,10,2011,7,36,34,77
Oromia,West Wellega,Gimbi Rural,Nehase,12,2010,20,13,26,59
Oromia,West Guji,Gelana,Hedar,3,2011,88,93,76,257
Oromia,North Shewa,Dera Hospital,Megabit,7,2011,94,18,43,155
Oromia,Ilu Aba Bora,Doreni,Ginbot,9,2011,17,17,54,88
Oromia,East Hararge,Kurfa Chele,Miyazia,8,2011,39,79,6,124
Oromia,West Guji,Biebirsa Kojowa,Sene,10,2011,94,43,74,211
Oromia,Jimma,Tiro Afeta,Tahesas,4,2011,39,98,59,196
Oromia,West Arsi,Adaba,Hedar,3,2010,42,51,59,152
Oromia,Jimma,Agaro,Tir,5,2010,7,53,60,120
Oromia,West Hararge,Habro,Meskerem,1,2011,29,1,57,87
Oromia,West Hararge,Guba Qoricha,Miyazia,8,2009,49,40,24,113
Oromia,East Shewa,Lomme,Meskerem,1,2011,56,95,33,184
Oromia,East Hararge,Babile Woreda,Sene,10,2010,83,91,70,244
Oromia,Ilu Aba Bora,Hurumu,Miyazia,8,2010,13,76,69,158
Oromia,Ilu Aba Bora,Algesachi,Sene,10,2010,78,16,96,190
Oromia,Bale,Goba Town,Ginbot,9,2010,86,58,26,170
Oromia,West Wellega,Gimbi,Hedar,3,2010,3,92,45,140
Oromia,Bale,Agarfa,Tir,5,2011,43,14,29,86
Oromia,Buno Bedele,Gechi,Teqemt,2,2010,13,57,83,153
Oromia,East Hararge,Goro Gutu,Sene,10,2009,92,84,78,254
Oromia,East Shewa,Adami Tulu Jido Kombolcha,Meskerem,1,2011,41,22,54,117
Oromia,Guji,Bore Hospital,Nehase,12,2010,11,73,8,92
Oromia,West Wellega,Boji Cheqorsa,Hedar,3,2011,70,30,33,133
Oromia,Borena,Wachile,Hamle,11,2010,70,15,9,94
Oromia,Jimma,Sigmo,Miyazia,8,2010,43,88,43,174
Oromia,South West Shewa,St.Luke Hospital,Sene,10,2010,35,10,41,86
Oromia,North Shewa,Aleiltu,Yekatit,6,2009,34,75,87,196
Oromia,Ilu Aba Bora,Halu,Tir,5,2011,47,7,70,124
Oromia,West Shewa,Ginde Beret,Miyazia,8,2009,37,67,81,185
Oromia,Arsi,Zeway Dugda,Sene,10,2009,70,95,81,246
Oromia,West Shewa,Meta Waliqite,Teqemt,2,2011,80,71,3,154
Oromia,Guji,Girja,Hedar,3,2010,90,80,61,231
Oromia,Bale,Meda Welabu,Hamle,11,2009,21,81,28,130
Oromia,West Guji,Suro Barguda,Hedar,3,2011,8,97,56,161
Oromia,South West Shewa,Becho,Tir,5,2010,12,93,95,200
Oromia,Jimma,Dedo,Megabit,7,2011,37,96,73,206
Oromia,East Wellega,Sasiga,Hedar,3,2010,68,95,59,222
Oromia,Arsi,Deksis,Sene,10,2011,25,73,9,107
Oromia,West Arsi,Gambo Hospital,Ginbot,9,2010,74,4,9,87
Oromia,Borena,Yabelo,Hamle,11,2010,36,67,60,163
Oromia,Arsi,Amigna,Miyazia,8,2011,6,19,6,31
Oromia,Jimma,Mancho,Megabit,7,2010,38,79,3,120
Oromia,East Shewa,Dugda,Megabit,7,2011,65,25,79,169
Oromia,North Shewa,Abichugna,Nehase,12,2009,68,56,46,170
Oromia,North Shewa,Fichetown,Ginbot,9,2011,48,55,66,169
Oromia,East Shewa,Adama,Tir,5,2011,74,94,82,250
Oromia,Arsi,Sude,Megabit,7,2009,85,72,32,189
Oromia,Qeleme Wellega,Dambi Dollo,Hedar,3,2011,48,33,14,95
Oromia,South West Shewa,St.Luke Hospital,Yekatit,6,2011,34,53,44,131
Oromia,Buno Bedele,Gechi,Yekatit,6,2009,47,71,47,165
Oromia,Bale,Gura Dhamole,Ginbot,9,2010,26,29,98,153
Oromia,West Hararge,Chiro Hospital,Tir,5,2009,51,67,22,140
Oromia,Jimma,Chora Boter,Teqemt,2,2011,20,60,56,136
Oromia,Ilu Aba Bora,Nono Sele,Tahesas,4,2011,86,18,33,137
Oromia,West Hararge,Mesela,Tahesas,4,2010,89,87,98,274
Oromia,East Shewa,Fentale,Megabit,7,2011,34,35,76,145
Oromia,South West Shewa,Becho,Tir,5,2009,5,64,64,133
Oromia,Bale,Arena Buluq,Ginbot,9,2010,74,94,26,194
Oromia,Borena,Yabelo Rural,Megabit,7,2010,84,43,9,136
Oromia,East Hararge,Kumbi,Nehase,12,2010,90,31,10,131
Oromia,Jimma,Omo Nada Hospital,Ginbot,9,2011,11,58,38,107
Oromia,East Hararge,Gole Oda,Yekatit,6,2011,73,39,51,163
Oromia,East Wellega,Limu,Hamle,11,2009,5,12,33,50
Oromia,Bale,Goba,Ginbot,9,2010,47,81,0,128
Oromia,Borena,Dilo,Hamle,11,2010,91,12,38,141
Oromia,Bale,Gura Dhamole,Yekatit,6,2010,80,83,80,243
Oromia,West Guji,Gelana,Hedar,3,2010,32,56,64,152
Oromia,North Shewa,Yaya Gulele,Tir,5,2009,87,90,74,251
Oromia,West Arsi,Kokosa  Hospital,Megabit,7,2010,87,50,95,232
Oromia,Buno Bedele,Bedele Hospital,Hedar,3,2011,76,88,98,262
Oromia,Borena,Meyo,Sene,10,2011,83,81,3,167
Oromia,West Shewa,Jeldu,Ginbot,9,2010,2,62,65,129
Oromia,Buno Bedele,Boricha,Hamle,11,2010,33,75,28,136
Oromia,Ilu Aba Bora,Nono Sele,Ginbot,9,2009,32,48,45,125
Oromia,Buno Bedele,Meko,Tir,5,2010,78,67,41,186
Oromia,Horo Gudru Wellega,Gudru,Teqemt,2,2010,14,82,41,137
Oromia,West Guji,Abaya,Tir,5,2010,26,68,88,182
Oromia,West Guji,Abaya,Meskerem,1,2011,73,54,33,160
Oromia,West Shewa,Liban Jawi,Hedar,3,2010,6,31,10,47
Oromia,Buno Bedele,Bedele Town,Megabit,7,2010,65,6,37,108
Oromia,West Wellega,Boji Cheqorsa,Tir,5,2010,96,86,83,265
Oromia,Arsi,Munesa,Tahesas,4,2010,58,16,80,154
Oromia,East Wellega,Limu,Tir,5,2011,68,18,14,100
Oromia,West Shewa,Nono,Hedar,3,2010,87,68,68,223
Oromia,Bale,Goro,Megabit,7,2011,96,3,89,188
Oromia,Guji,Girja,Ginbot,9,2011,14,31,11,56
Oromia,Bale,Agarfa,Ginbot,9,2010,74,97,16,187
Oromia,West Hararge,Gemechis,Sene,10,2011,26,85,77,188
Oromia,Buno Bedele,Bedele Town,Hedar,3,2010,55,38,0,93
Oromia,Borena,Guchi,Hedar,3,2010,86,59,76,221
Oromia,West Arsi,Wondo,Tahesas,4,2011,76,73,90,239
Oromia,West Wellega,Gimbi Public  Hospital,Megabit,7,2010,18,31,58,107
Oromia,West Wellega,Kundala,Miyazia,8,2010,14,33,2,49
Oromia,West Shewa,Ginde Beret,Nehase,12,2010,37,43,86,166
Oromia,Jimma,Kersa,Sene,10,2010,78,80,10,168
Oromia,East Wellega,Boneya Bushe,Yekatit,6,2009,63,78,0,141
Oromia,West Wellega,Gimbi Rural,Tir,5,2009,47,92,81,220
Oromia,Qeleme Wellega,Gidami,Miyazia,8,2010,76,29,15,120
Oromia,West Shewa,Gedo Hospital,Miyazia,8,2011,33,49,79,161
Oromia,Arsi,Munesa,Hedar,3,2010,63,21,83,167
Oromia,Ilu Aba Bora,Yayu,Yekatit,6,2009,69,37,69,175
Oromia,West Guji,Bule Hora Hospital,Miyazia,8,2009,9,29,80,118
Oromia,West Arsi,Gedeb Asasa,Megabit,7,2011,14,25,29,68
Oromia,Jimma,Shabe,Megabit,7,2011,59,78,44,181
Oromia,East Shewa,Matahara,Sene,10,2011,42,2,66,110
Oromia,East Hararge,Jarso,Miyazia,8,2010,72,31,25,128
Oromia,Guji,Shakiso Town,Ginbot,9,2011,75,51,98,224
Oromia,East Wellega,Sasiga,Sene,10,2009,38,66,76,180
Oromia,South West Shewa,Dawo,Tir,5,2010,11,53,9,73
Oromia,Arsi,Merti,Hamle,11,2010,44,1,33,78
Oromia,West Shewa,Gindeberet Hospital,Teqemt,2,2010,70,4,19,93
Oromia,West Wellega,Haru,Yekatit,6,2011,27,61,41,129
Oromia,Borena,Dhas,Tir,5,2011,90,49,19,158
Oromia,Guji,Bore Hospital,Tahesas,4,2011,15,73,8,96
Oromia,Guji,Liben,Ginbot,9,2011,87,91,47,225
Oromia,West Shewa,Ejersa Lafo,Megabit,7,2009,15,14,50,79
Oromia,Guji,Aga Wayyu,Ginbot,9,2010,6,85,90,181
Oromia,West Wellega,Kundala,Miyazia,8,2010,18,44,36,98
Oromia,Borena,Wachile,Meskerem,1,2010,3,77,5,85
Oromia,Qeleme Wellega,Gawo Qebe,Megabit,7,2011,33,9,97,139
Oromia,West Shewa,Chelia,Yekatit,6,2009,70,32,65,167
Oromia,West Guji,Bule Hora Hospital,Sene,10,2009,34,67,49,150
Oromia,Arsi,Munesa,Ginbot,9,2011,41,25,33,99
Oromia,East Wellega,Boneya Bushe,Hedar,3,2010,16,69,84,169
Oromia,East Hararge,Gursum,Sene,10,2009,12,0,19,31
Oromia,Guji,Dima,Hedar,3,2011,29,43,86,158
Oromia,West Wellega,Homa,Hedar,3,2011,68,17,74,159
Oromia,West Guji,Hanbala,Megabit,7,2010,8,2,9,19
Oromia,Bale,Gura Dhamole,Yekatit,6,2011,55,8,84,147
Oromia,Assela Town,Assela Town,Megabit,7,2010,23,85,1,109
Oromia,West Hararge,Anchar,Yekatit,6,2009,19,26,85,130
Oromia,East Hararge,Kersa Eh,Ginbot,9,2009,31,69,86,186
Oromia,Jimma,Gera,Hedar,3,2010,13,26,18,57
Oromia,East Shewa,Matahara,Tir,5,2011,67,61,17,145
Oromia,West Shewa,Tibe Kutaye,Yekatit,6,2011,57,44,40,141
Oromia,East Shewa,Dugda,Megabit,7,2009,1,85,46,132
Oromia,West Hararge,Bedesa Town,Nehase,12,2010,43,71,8,122
Oromia,West Wellega,Qiltu Kara,Meskerem,1,2010,0,97,59,156
Oromia,West Wellega,Gimbi Adventist Hospital,Nehase,12,2009,61,53,1,115
Oromia,Arsi,Bale Gesgara,Nehase,12,2009,7,62,87,156
Oromia,West Hararge,Doba,Teqemt,2,2010,23,96,73,192
Oromia,Qeleme Wellega,Sedan Chanka,Miyazia,8,2010,45,47,33,125
Oromia,Arsi,Zeway Dugda,Megabit,7,2009,79,95,37,211
Oromia,West Arsi,Dodola Rural,Nehase,12,2010,36,38,17,91
Oromia,Bale,Goro,Ginbot,9,2009,83,58,72,213
Oromia,East Shewa,Matahara,Megabit,7,2010,85,49,55,189
Oromia,East Hararge,Deder Hospital,Yekatit,6,2011,76,55,13,144
Oromia,Bale,Robe Town,Nehase,12,2009,75,63,30,168
Oromia,Buno Bedele,Dapho Hana,Miyazia,8,2010,25,98,81,204
Oromia,North Shewa,Dera Hospital,Miyazia,8,2011,11,22,79,112
Oromia,West Wellega,Gimbi,Nehase,12,2009,56,69,28,153
Oromia,West Shewa,Gindeberet Hospital,Miyazia,8,2011,28,50,52,130
Oromia,Jimma,Omo Nada Hospital,Hedar,3,2011,7,27,72,106
Oromia,East Wellega,Sasiga,Nehase,12,2010,78,3,84,165
Oromia,West Wellega,Gimbi Public  Hospital,Tahesas,4,2011,99,31,11,141
Oromia,Arsi,Aseko,Hedar,3,2010,17,99,15,131
Oromia,Borena,El Way,Sene,10,2011,78,39,7,124
Oromia,Finfine Zuria,Berreh,Sene,10,2009,37,58,6,101
Oromia,Arsi,Limuna Bilbilo,Ginbot,9,2011,57,76,11,144
Oromia,Borena,Yabelo Hospital,Meskerem,1,2011,42,32,97,171
Oromia,North Shewa,Dera Hospital,Sene,10,2009,57,94,81,232
Oromia,North Shewa,Abichugna,Tahesas,4,2010,83,40,54,177
Oromia,Jimma,Limu Seka,Megabit,7,2011,60,20,11,91
Oromia,West Wellega,Nole Kaba,Nehase,12,2009,89,69,58,216
Oromia,North Shewa,Hidabu Abote,Nehase,12,2010,7,11,40,58
Oromia,Buno Bedele,Bedele Hospital,Teqemt,2,2010,7,30,17,54
Oromia,East Hararge,Deder Town,Hedar,3,2010,43,0,60,103
Oromia,West Hararge,Oda Bultum,Miyazia,8,2009,89,2,86,177
Oromia,Borena,Guchi,Miyazia,8,2010,36,15,10,61
Oromia,West Shewa,Liban Jawi,Megabit,7,2009,63,38,78,179
Oromia,West Arsi,Arsi Negele Rural,Megabit,7,2009,58,23,70,151
Oromia,North Shewa,Kimbibit,Tir,5,2010,85,80,48,213
Oromia,South West Shewa,Ilu,Meskerem,1,2010,60,80,81,221
Oromia,Borena,Dilo,Ginbot,9,2010,22,40,41,103
Oromia,East Wellega,Haro Limu,Sene,10,2011,27,98,43,168
Oromia,West Wellega,Begi Hospital,Miyazia,8,2009,98,70,50,218
Oromia,West Guji,Kercha Hospital,Meskerem,1,2011,82,96,29,207
Oromia,Jimma,Dedo,Sene,10,2009,51,82,74,207
Oromia,Gelan Town,Gelan Town,Tir,5,2011,26,56,10,92
Oromia,East Hararge,Gole Oda,Nehase,12,2010,57,45,2,104
Oromia,Guji,Goro Dola,Nehase,12,2010,17,71,31,119
Oromia,West Shewa,Inchini Hospital,Tir,5,2009,22,73,55,150
Oromia,East Shewa,Dugda,Yekatit,6,2010,93,88,70,251
Oromia,East Hararge,Gursum,Sene,10,2010,99,52,35,186
Oromia,Guji,Liben,Nehase,12,2010,11,12,42,65
Oromia,Borena,Dire,Meskerem,1,2011,47,12,70,129
Oromia,West Shewa,Ejerie,Hedar,3,2010,23,69,4,96
Oromia,West Wellega,Lata Sibu,Hedar,3,2010,35,2,53,90
Oromia,East Hararge,Haromaya Rural,Meskerem,1,2011,32,38,34,104
Oromia,North Shewa,Dera Hospital,Sene,10,2009,15,85,29,129
Oromia,West Shewa,Jibat,Megabit,7,2009,68,97,23,188
Oromia,Qeleme Wellega,Anfilo,Sene,10,2010,39,74,15,128
Oromia,Jimma,Limu Seka,Nehase,12,2009,8,53,1,62
Oromia,Guji,Adola Hospital,Tir,5,2009,66,14,25,105
Oromia,East Hararge,Bisidimo Hospital,Yekatit,6,2010,60,98,78,236
Oromia,East Hararge,Bedeno,Hamle,11,2009,36,12,66,114
Oromia,East Hararge,Haromaya Town,Megabit,7,2010,98,88,78,264
Oromia,Arsi,Enkelo Wabe,Miyazia,8,2011,19,81,96,196
Oromia,Jimma,Chora Boter,Ginbot,9,2009,13,47,35,95
Oromia,West Shewa,Ambo,Sene,10,2010,48,19,28,95
Oromia,West Guji,Kercha,Tir,5,2010,36,17,48,101
Oromia,Arsi,Ludehetosa,Ginbot,9,2009,19,22,96,137
Oromia,Bale,Arena Buluq,Teqemt,2,2011,84,69,20,173
Oromia,East Hararge,Kurfa Chele,Sene,10,2010,85,89,0,174
Oromia,Finfine Zuria,Mullo,Ginbot,9,2009,64,84,91,239
Oromia,West Wellega,Haru,Miyazia,8,2009,89,78,9,176
Oromia,East Hararge,Garemuleta Hospital,Yekatit,6,2009,18,63,32,113
Oromia,Jimma,Kersa,Nehase,12,2010,89,41,85,215
Oromia,West Shewa,Adea Berga,Tahesas,4,2010,17,3,74,94
Oromia,East Wellega,Wayu Tuqa,Tahesas,4,2010,16,37,86,139
Oromia,West Wellega,Nole Kaba,Meskerem,1,2011,45,55,31,131
Oromia,South West Shewa,Tole,Ginbot,9,2009,96,68,34,198
Oromia,West Wellega,Mendi Hospital,Hamle,11,2009,67,46,53,166
Oromia,East Hararge,Deder,Nehase,12,2010,63,69,70,202
Oromia,East Wellega,Leqa Dulecha,Teqemt,2,2011,68,70,69,207
Oromia,Lege Dadi Lege Tafo Town,Lege Dadi Lege Tafo Town,Ginbot,9,2010,37,74,68,179
Oromia,Bale,Ginir Town,Yekatit,6,2010,66,89,35,190
Oromia,North Shewa,Kuyu Hospital,Nehase,12,2009,27,78,39,144
Oromia,North Shewa,Fichetown,Yekatit,6,2010,82,59,72,213
Oromia,Arsi,Merti,Tahesas,4,2010,50,87,20,157
Oromia,West Hararge,West Harerge	Gumbi Bordede,Tir,5,2009,6,12,91,109
Oromia,Arsi,Hitosa,Yekatit,6,2011,74,70,18,162
Oromia,North Shewa,Debre Libanos,Megabit,7,2010,28,49,94,171
Oromia,Ilu Aba Bora,Doreni,Nehase,12,2009,33,76,77,186
Oromia,Arsi,Ludehetosa,Ginbot,9,2011,74,55,77,206
Oromia,East Wellega,Gudeyabila,Miyazia,8,2009,34,90,83,207
Oromia,Arsi,Tiyo,Miyazia,8,2009,93,3,96,192
Oromia,Bale,Arena Buluq,Tir,5,2011,25,53,11,89
Oromia,Qeleme Wellega,Gidami,Meskerem,1,2011,68,0,40,108
Oromia,Borena,Yabelo,Nehase,12,2009,21,68,58,147
Oromia,Bale,Dawe Serar,Teqemt,2,2010,51,25,94,170
Oromia,West Hararge,Oda Bultum,Tir,5,2009,24,2,62,88
Oromia,Buno Bedele,Bedele Zuriya,Megabit,7,2011,48,11,49,108
Oromia,Nekemte Town,Nekemte Town,Megabit,7,2011,30,80,74,184
Oromia,West Wellega,Seyo Nole,Miyazia,8,2011,19,83,77,179
Oromia,West Arsi,Kokosa  Hospital,Megabit,7,2010,4,10,59,73
Oromia,Ilu Aba Bora,Doreni,Miyazia,8,2011,98,77,62,237
Oromia,Jimma,Limu Seka,Tir,5,2010,60,41,14,115
Oromia,West Guji,Mkelka Soda,Megabit,7,2010,32,97,46,175
Oromia,Ilu Aba Bora,Hurumu,Teqemt,2,2011,73,96,16,185
Oromia,Guji,Uraga,Miyazia,8,2009,6,19,38,63
Oromia,Jimma,Sekoru,Teqemt,2,2010,23,86,34,143
Oromia,Bale,Goro,Teqemt,2,2011,97,75,7,179
Oromia,Finfine Zuria,Sululta Town,Miyazia,8,2010,61,29,83,173
Oromia,Guji,Adola Hospital,Tir,5,2011,63,26,79,168
Oromia,South West Shewa,Woliso Town,Ginbot,9,2009,18,76,95,189
Oromia,Guji,Negele Town,Teqemt,2,2010,55,86,25,166
Oromia,Arsi,Sude,Miyazia,8,2010,28,15,85,128
Oromia,West Arsi,Nensebo,Ginbot,9,2009,80,65,25,170
Oromia,West Guji,Bule Hora Toun,Miyazia,8,2010,4,79,78,161
Oromia,Horo Gudru Wellega,Abe Dengoro,Yekatit,6,2009,28,79,75,182
Oromia,Arsi,Jeju,Nehase,12,2009,80,0,7,87
Oromia,West Hararge,Bedesa Town,Nehase,12,2009,35,23,72,130
Oromia,Arsi,Gololcha,Hedar,3,2011,72,4,58,134
Oromia,East Hararge,Kombolicha,Hamle,11,2010,67,41,68,176
Oromia,Guji,Bore Hospital,Hedar,3,2011,99,37,81,217
Oromia,Qeleme Wellega,Jimma Horo,Tir,5,2010,36,60,63,159
Oromia,East Hararge,Kersa Eh,Nehase,12,2009,81,45,64,190
Oromia,North Shewa,Debre Libanos,Ginbot,9,2011,94,31,82,207
Oromia,South West Shewa,Tole,Meskerem,1,2011,81,18,24,123
Oromia,East Wellega,Limu,Sene,10,2009,36,77,51,164
Oromia,West Hararge,Chiro Town,Hedar,3,2011,28,55,92,175
Oromia,Finfine Zuria,Sebeta Awas,Ginbot,9,2011,40,79,76,195
Oromia,West Arsi,Adaba,Tahesas,4,2011,33,59,4,96
Oromia,North Shewa,Degem,Teqemt,2,2011,25,40,7,72
Oromia,Guji,Uraga,Yekatit,6,2009,9,85,53,147
Oromia,Arsi,Bale Gesgara,Yekatit,6,2011,82,79,77,238
Oromia,East Hararge,Fedis,Yekatit,6,2010,13,6,36,55
Oromia,Bale,Ginir,Teqemt,2,2010,40,67,84,191
Oromia,Qeleme Wellega,Gidami Hosp,Teqemt,2,2011,44,83,8,135
Oromia,West Wellega,Boji Cheqorsa,Ginbot,9,2009,83,35,83,201
Oromia,Arsi,Sire,Tir,5,2009,26,12,53,91
Oromia,Arsi,Ludehetosa,Nehase,12,2010,77,88,36,201
Oromia,Finfine Zuria,Walmera,Megabit,7,2010,65,5,24,94
Oromia,Arsi,Hitosa,Hamle,11,2009,4,90,28,122
Oromia,Borena,Gomole,Ginbot,9,2010,22,80,39,141
Oromia,Guji,Adola Reda,Ginbot,9,2009,41,80,22,143
Oromia,Buno Bedele,Bedele Town,Nehase,12,2009,45,66,96,207
Oromia,Qeleme Wellega,Jimma Horo,Sene,10,2009,26,62,75,163
Oromia,East Wellega,Nunu Qumba,Teqemt,2,2010,73,21,1,95
Oromia,West Wellega,Lata Sibu,Hedar,3,2010,58,71,80,209
Oromia,South West Shewa,Ameya,Yekatit,6,2009,67,24,0,91
Oromia,Arsi,Zeway Dugda,Megabit,7,2010,12,98,39,149
Oromia,Jimma,Mana,Yekatit,6,2011,72,28,20,120
Oromia,Jimma,Dedo,Miyazia,8,2011,68,16,56,140
Oromia,Gelan Town,Gelan Town,Ginbot,9,2009,5,57,43,105
Oromia,Arsi,Zeway Dugda,Yekatit,6,2009,47,92,78,217
Oromia,Arsi,Merti,Tir,5,2010,32,65,91,188
Oromia,West Hararge,West Harerge	Gumbi Bordede,Teqemt,2,2011,44,74,69,187
Oromia,West Guji,Bule Hora Toun,Meskerem,1,2011,84,0,53,137
Oromia,West Arsi,Adaba,Sene,10,2009,97,29,31,157
Oromia,Finfine Zuria,Berreh,Miyazia,8,2009,63,35,13,111
Oromia,Guji,Negele Hospital,Tahesas,4,2010,10,58,71,139
Oromia,West Arsi,Kore,Miyazia,8,2010,95,49,96,240
Oromia,Jimma,Guma,Yekatit,6,2011,95,22,68,185
Oromia,Arsi,Gololcha,Sene,10,2009,85,53,36,174
Oromia,Guji,Negele Hospital,Yekatit,6,2010,56,96,97,249
Oromia,West Arsi,Gambo Hospital,Miyazia,8,2009,3,68,43,114
Oromia,East Shewa,Liben,Yekatit,6,2011,19,37,91,147
Oromia,West Shewa,Bako Tibe,Nehase,12,2010,15,84,70,169
Oromia,Arsi,Tiyo,Yekatit,6,2010,26,5,44,75
Oromia,Jimma,Omonada,Hamle,11,2009,12,32,69,113
Oromia,South West Shewa,Ameya Hospital,Tir,5,2011,2,23,87,112
Oromia,East Wellega,Wama Hagelo,Megabit,7,2011,9,78,32,119
Oromia,North Shewa,Fiche Hospital,Hedar,3,2011,28,3,77,108
Oromia,West Arsi,Kokosa,Ginbot,9,2010,80,10,14,104
Oromia,East Hararge,Jarso,Ginbot,9,2010,72,25,39,136
Oromia,South West Shewa,Kersana Malima,Hedar,3,2010,1,99,65,165
Oromia,West Arsi,Wondo,Hamle,11,2010,91,93,42,226
Oromia,Horo Gudru Wellega,Abay Chomen,Megabit,7,2010,47,61,84,192
Oromia,Bale,Arena Buluq,Ginbot,9,2011,15,89,87,191
Oromia,Arsi,Digeluna Tijo,Teqemt,2,2011,1,96,97,194
Oromia,Guji,Bore,Miyazia,8,2010,74,36,12,122
Oromia,West Shewa,Liban Jawi,Teqemt,2,2010,47,83,74,204
Oromia,West Shewa,Adea Berga,Ginbot,9,2010,66,58,93,217
Oromia,Arsi,Dodota,Miyazia,8,2011,48,34,40,122
Oromia,Borena,Yabelo,Teqemt,2,2011,29,73,6,108
Oromia,Horo Gudru Wellega,Amuru,Hamle,11,2009,24,9,66,99
Oromia,Borena,Guchi,Yekatit,6,2009,40,66,90,196
Oromia,Arsi,Deksis,Ginbot,9,2010,56,31,74,161
Oromia,Buno Bedele,Bedele Zuriya,Ginbot,9,2009,43,70,80,193
Oromia,West Shewa,Jeldu,Hedar,3,2011,46,13,85,144
Oromia,Bale,Ginir,Ginbot,9,2010,15,59,0,74
Oromia,South West Shewa,Tole,Yekatit,6,2009,15,47,12,74
Oromia,East Wellega,Limu,Miyazia,8,2011,1,35,83,119
Oromia,Jimma,B/Tolyi,Teqemt,2,2010,43,67,44,154
Oromia,East Wellega,Kiremu,Teqemt,2,2011,89,69,48,206
Oromia,West Shewa,Ejerie,Hamle,11,2009,16,30,11,57
Oromia,Borena,Dhas,Megabit,7,2009,87,93,9,189
Oromia,West Shewa,Gojo Hospital,Nehase,12,2010,5,77,1,83
Oromia,West Shewa,Gojo Hospital,Hamle,11,2009,45,49,79,173
Oromia,Finfine Zuria,Sandefa,Tahesas,4,2011,65,20,98,183
Oromia,West Guji,Hanbala,Nehase,12,2010,3,56,34,93
Oromia,Finfine Zuria,Sululta Town,Ginbot,9,2011,12,72,28,112
Oromia,South West Shewa,Goro,Tahesas,4,2011,72,49,45,166
Oromia,East Hararge,Goro Gutu,Ginbot,9,2010,83,53,52,188
Oromia,West Wellega,Mendi Town,Sene,10,2009,42,81,97,220
Oromia,West Shewa,Ilu Galan,Yekatit,6,2011,31,93,52,176
Oromia,East Hararge,Kumbi,Yekatit,6,2009,94,79,34,207
Oromia,Shashamane Town,Shashamane Town,Miyazia,8,2011,11,77,81,169
Oromia,Horo Gudru Wellega,Jarte Jardga,Teqemt,2,2011,84,3,24,111
Oromia,East Hararge,Deder Hospital,Ginbot,9,2010,94,45,66,205
Oromia,Arsi,Robe,Ginbot,9,2011,66,49,97,212
Oromia,Jimma,Dedo,Megabit,7,2010,49,28,63,140
Oromia,Borena,Yabelo Hospital,Miyazia,8,2009,4,62,50,116
Oromia,West Guji,Bule Hora Toun,Tahesas,4,2010,77,89,17,183
Oromia,Buno Bedele,Diga,Meskerem,1,2011,84,53,30,167
Oromia,East Wellega,Haro Limu,Tir,5,2009,52,37,41,130
Oromia,East Hararge,Melka Belo,Hedar,3,2011,77,91,80,248
Oromia,Arsi,Merti,Miyazia,8,2010,82,58,80,220
Oromia,Qeleme Wellega,Laloqile,Megabit,7,2010,37,80,45,162
Oromia,East Shewa,Adami Tulu Jido Kombolcha,Nehase,12,2010,49,13,82,144
Oromia,Bale,Agarfa,Teqemt,2,2010,57,55,65,177
Oromia,Jimma,Mancho,Tahesas,4,2010,52,12,30,94
Oromia,East Hararge,Haromaya Rural,Tir,5,2010,59,63,41,163
Oromia,Qeleme Wellega,Seyo,Megabit,7,2011,17,77,70,164
Oromia,Ilu Aba Bora,Algesachi,Tir,5,2010,92,90,58,240
Oromia,East Shewa,Dugda,Meskerem,1,2010,84,66,59,209
Oromia,East Wellega,Wayu Tuqa,Miyazia,8,2009,61,20,76,157
Oromia,East Wellega,Diga,Yekatit,6,2009,78,47,45,170
Oromia,West Guji,Bule Hora Hospital,Ginbot,9,2009,38,59,43,140
Oromia,Bale,Gololcha,Miyazia,8,2011,56,16,43,115
Oromia,Finfine Zuria,Berreh,Sene,10,2009,48,14,10,72
Oromia,Holeta Town,Holeta Town,Yekatit,6,2010,74,68,60,202
Oromia,Arsi,Dodota,Hedar,3,2010,41,85,76,202
Oromia,West Wellega,Qiltu Kara,Ginbot,9,2011,33,44,14,91
Oromia,Borena,Arero,Sene,10,2011,27,35,96,158
Oromia,East Wellega,Jimma Arjo,Miyazia,8,2009,3,98,15,116
Oromia,East Hararge,Garemuleta Hospital,Teqemt,2,2010,23,7,27,57
Oromia,Bale,Goba Town,Megabit,7,2010,84,74,91,249
Oromia,West Shewa,Ejersa Lafo,Megabit,7,2011,34,57,16,107
Oromia,North Shewa,Abichugna,Hedar,3,2010,13,1,5,19
Oromia,Jimma,Gomma,Sene,10,2011,86,2,49,137
Oromia,West Hararge,Doba,Megabit,7,2011,30,5,31,66
Oromia,West Guji,Mkelka Soda,Ginbot,9,2009,39,52,3,94
Oromia,West Arsi,Dodola Town,Nehase,12,2010,83,77,68,228
Oromia,Assela Town,Assela Town,Tir,5,2009,47,91,33,171
Oromia,West Wellega,Genji,Tir,5,2010,7,6,22,35
Oromia,Nekemte Town,Nekemte Town,Yekatit,6,2009,22,54,26,102
Oromia,Qeleme Wellega,Gawo Qebe,Tir,5,2011,88,51,14,153
Oromia,West Hararge,Bedesa Town,Megabit,7,2011,48,13,19,80
Oromia,Horo Gudru Wellega,Jarte Jardga,Megabit,7,2011,89,33,68,190
Oromia,Ilu Aba Bora,Bure,Nehase,12,2010,42,49,1,92
Oromia,Arsi,Deksis,Tahesas,4,2010,14,98,62,174
Oromia,Guji,Bore,Yekatit,6,2009,53,34,87,174
Oromia,Ilu Aba Bora,Algesachi,Tahesas,4,2010,12,76,83,171
Oromia,East Wellega,Boneya Bushe,Hamle,11,2010,71,69,11,151
Oromia,East Wellega,Nunu Qumba,Hedar,3,2010,66,93,3,162
Oromia,East Hararge,Meta,Tir,5,2009,9,26,48,83
Oromia,Lege Dadi Lege Tafo Town,Lege Dadi Lege Tafo Town,Tir,5,2010,52,65,14,131
Oromia,East Wellega,Jimma Arjo,Tir,5,2010,75,2,93,170
Oromia,Bale,Berbere,Miyazia,8,2010,89,20,21,130
Oromia,West Wellega,Gimbi,Miyazia,8,2009,7,2,45,54
Oromia,Arsi,Ludehetosa,Yekatit,6,2011,72,3,37,112
Oromia,Guji,Adola Town,Teqemt,2,2010,25,4,50,79
Oromia,Qeleme Wellega,Seyo,Yekatit,6,2010,80,84,66,230
Oromia,West Hararge,Gelemso Hospital,Tahesas,4,2010,42,46,48,136
Oromia,East Hararge,Deder Hospital,Teqemt,2,2011,88,39,61,188
Oromia,Sebeta Town,Sebeta Town,Miyazia,8,2011,34,2,40,76
Oromia,East Hararge,Aweday Town,Hamle,11,2009,47,10,5,62
Oromia,Bale,Arena Buluq,Sene,10,2009,67,58,89,214
Oromia,West Arsi,Arsi Negele Town,Ginbot,9,2011,17,69,69,155
Oromia,Jimma,Limu Hospital,Yekatit,6,2010,81,20,32,133
Oromia,West Shewa,Metarobi,Megabit,7,2011,30,84,93,207
Oromia,West Guji,Dugda Dawa,Nehase,12,2010,5,47,0,52
Oromia,West Shewa,Ejerie,Ginbot,9,2009,88,13,82,183
Oromia,Finfine Zuria,Akaki,Nehase,12,2009,23,58,87,168
Oromia,Arsi,Shenan Kolu,Miyazia,8,2010,3,83,33,119
Oromia,Jimma,O/Beyam,Miyazia,8,2010,64,48,58,170
Oromia,West Wellega,Jarso,Ginbot,9,2010,26,48,42,116
Oromia,Qeleme Wellega,Sedan Chanka,Teqemt,2,2010,52,10,68,130
Oromia,East Shewa,Fentale,Tahesas,4,2010,84,31,6,121
Oromia,Qeleme Wellega,Dale Wabera,Ginbot,9,2010,22,89,99,210
Oromia,Burayu Town,Burayu Town,Miyazia,8,2009,30,57,75,162
Oromia,West Shewa,Elifata,Ginbot,9,2009,51,56,27,134
Oromia,Borena,Yabelo,Miyazia,8,2009,14,83,66,163
Oromia,North Shewa,Aleiltu,Megabit,7,2009,31,59,86,176
Oromia,East Wellega,Sibu Sire,Hedar,3,2010,20,68,37,125
Oromia,East Hararge,Haromaya Town,Nehase,12,2010,62,76,44,182
Oromia,Burayu Town,Burayu Town,Tahesas,4,2010,27,65,69,161
Oromia,North Shewa,Debre Libanos,Tir,5,2010,7,75,10,92
Oromia,South West Shewa,Wonchi,Yekatit,6,2010,30,53,6,89
Oromia,West Shewa,Liban Jawi,Ginbot,9,2010,98,14,24,136
Oromia,Jimma,Limu Kosa,Hamle,11,2010,96,6,10,112
Oromia,West Arsi,Siraro,Hedar,3,2011,84,15,31,130
Oromia,Horo Gudru Wellega,Chomen Guduru,Teqemt,2,2010,88,46,12,146
Oromia,West Wellega,Gimbi Rural,Hedar,3,2010,85,25,25,135
Oromia,West Arsi,Hebal Arsi,Tahesas,4,2011,14,29,88,131
Oromia,Shashamane Town,Shashamane Town,Ginbot,9,2009,52,0,61,113
Oromia,West Wellega,Gimbi,Hedar,3,2010,66,17,41,124
Oromia,Buno Bedele,Bedele Town,Yekatit,6,2009,98,93,50,241
Oromia,West Arsi,Gedeb Asasa,Meskerem,1,2010,39,84,42,165
Oromia,East Hararge,Haromaya Rural,Hamle,11,2009,22,70,50,142
Oromia,Borena,Meyo,Hedar,3,2010,2,54,73,129
Oromia,Horo Gudru Wellega,Amuru,Nehase,12,2009,46,20,3,69
Oromia,Arsi,Limuna Bilbilo,Meskerem,1,2010,87,53,80,220
Oromia,Arsi,Chole,Sene,10,2009,97,94,49,240
Oromia,Jimma,Chora Boter,Ginbot,9,2011,10,89,33,132
Oromia,West Shewa,Tikur Enchini,Tir,5,2009,48,74,79,201
Oromia,East Hararge,Haromaya Hospital,Hedar,3,2010,40,34,11,85
Oromia,East Hararge,Meta,Yekatit,6,2010,97,63,12,172
Oromia,East Wellega,Wayu Tuqa,Hedar,3,2010,85,10,7,102
Oromia,Bale,Legehida,Ginbot,9,2011,63,51,4,118
Oromia,West Wellega,Gimbi,Teqemt,2,2011,73,69,60,202
Oromia,Qeleme Wellega,Hawa Gelan,Megabit,7,2010,98,39,89,226
Oromia,West Hararge,Habro,Meskerem,1,2010,70,70,89,229
Oromia,West Guji,Bule Hora Toun,Tir,5,2010,66,43,67,176
Oromia,West Hararge,Chiro Hospital,Megabit,7,2010,61,12,79,152
Oromia,West Shewa,Chelia,Ginbot,9,2009,40,5,35,80
Oromia,West Shewa,Nono,Hamle,11,2010,54,17,65,136
Oromia,West Arsi,Wondo,Tir,5,2011,87,76,56,219
Oromia,Arsi,Robe,Teqemt,2,2011,86,67,85,238
Oromia,Horo Gudru Wellega,Jima Rare,Sene,10,2010,20,17,44,81
Oromia,Borena,Dhas,Sene,10,2010,3,56,81,140
Oromia,Buno Bedele,Meko,Meskerem,1,2011,68,99,49,216
Oromia,Arsi,Munesa,Tahesas,4,2011,43,7,31,81
Oromia,Assela Town,Assela Town,Tir,5,2010,50,57,23,130
Oromia,West Wellega,Nejo Town,Tir,5,2011,71,15,26,112
Oromia,Jimma,Mana,Sene,10,2009,84,43,34,161
Oromia,Bale,Ginir,Hamle,11,2009,31,49,41,121
Oromia,Jimma,Sekoru,Hedar,3,2011,47,7,17,71
Oromia,East Wellega,Jimma Arjo,Hamle,11,2009,52,5,49,106
Oromia,West Shewa,Ambo Hospital,Sene,10,2009,93,13,93,199
Oromia,Borena,Dire,Miyazia,8,2009,4,42,11,57
Oromia,Bale,Legehida,Yekatit,6,2010,65,60,77,202
Oromia,Arsi,Ludehetosa,Tir,5,2010,12,45,17,74
Oromia,Arsi,Ludehetosa,Hedar,3,2011,63,12,46,121
Oromia,West Guji,Bule Hora Toun,Miyazia,8,2010,47,93,29,169
Oromia,West Shewa,Tibe Kutaye,Ginbot,9,2011,79,20,93,192
Oromia,Bale,Goro,Sene,10,2011,95,50,94,239
Oromia,Sebeta Town,Sebeta Town,Sene,10,2010,19,81,9,109
Oromia,North Shewa,Debre Libanos,Megabit,7,2010,24,50,99,173
Oromia,Bale,Raitu,Teqemt,2,2010,94,90,0,184
Oromia,Jimma,O/Beyam,Nehase,12,2009,30,57,0,87
Oromia,Arsi,Jeju,Nehase,12,2009,70,71,96,237
Oromia,West Guji,Abaya,Nehase,12,2009,55,56,91,202
Oromia,West Shewa,Inchini Hospital,Miyazia,8,2011,59,22,61,142
Oromia,West Shewa,Dendi,Hedar,3,2010,29,26,89,144
Oromia,Arsi,Chole,Tir,5,2011,45,62,98,205
Oromia,East Hararge,Jarso,Ginbot,9,2011,41,59,92,192
Oromia,West Wellega,Mene Sibu,Hamle,11,2009,14,61,27,102
Oromia,Jimma,Dedo,Sene,10,2010,40,48,65,153
Oromia,East Wellega,Kiremu,Miyazia,8,2010,87,94,17,198
Oromia,Guji,Wadara,Hamle,11,2010,42,87,76,205
Oromia,East Wellega,Gobu Seyo,Hamle,11,2010,1,83,35,119
Oromia,West Hararge,West Harerge	Gumbi Bordede,Nehase,12,2009,9,59,65,133
Oromia,Ilu Aba Bora,Yayu,Hamle,11,2010,93,77,91,261
Oromia,East Wellega,Sasiga,Teqemt,2,2011,59,24,20,103
Oromia,West Wellega,Begi,Sene,10,2009,20,76,39,135
Oromia,Guji,Anna Sora,Ginbot,9,2011,45,9,47,101
Oromia,North Shewa,Girar Jarso,Meskerem,1,2011,10,29,81,120
Oromia,East Wellega,Leqa Dulecha,Megabit,7,2010,2,52,96,150
Oromia,East Wellega,Wayu Tuqa,Yekatit,6,2009,62,25,64,151
Oromia,Robe Town,Robe Town,Megabit,7,2010,95,16,71,182
Oromia,Jimma,Limu Kosa,Sene,10,2011,68,86,45,199
Oromia,North Shewa,Yaya Gulele,Ginbot,9,2010,61,48,50,159
Oromia,East Hararge,Haromaya Hospital,Nehase,12,2009,23,92,23,138
Oromia,Borena,Guchi,Miyazia,8,2009,77,66,10,153
Oromia,Borena,El Way,Megabit,7,2010,80,58,30,168
Oromia,Ilu Aba Bora,Algesachi,Hamle,11,2009,97,35,35,167
Oromia,West Shewa,Ejerie,Sene,10,2011,47,80,38,165
Oromia,East Wellega,Nunu Qumba,Sene,10,2010,47,27,71,145
Oromia,West Guji,Bule Hora Hospital,Sene,10,2010,21,98,15,134
Oromia,West Hararge,Doba,Nehase,12,2009,15,20,86,121
Oromia,Borena,Arero,Hedar,3,2010,89,93,47,229
Oromia,Ilu Aba Bora,Didu,Teqemt,2,2010,21,97,75,193
Oromia,West Shewa,Gedo Hospital,Teqemt,2,2010,47,84,72,203
Oromia,West Shewa,Ejersa Lafo,Nehase,12,2009,5,8,52,65
Oromia,West Shewa,Guder Hosp,Ginbot,9,2010,87,52,60,199
Oromia,East Wellega,Haro Limu,Tahesas,4,2010,97,80,8,185
Oromia,East Shewa,Fentale,Nehase,12,2010,43,16,46,105
Oromia,West Hararge,Burka Dimtu,Ginbot,9,2009,51,7,49,107
Oromia,Buno Bedele,Meko,Tahesas,4,2011,20,11,44,75
Oromia,South West Shewa,Kersana Malima,Teqemt,2,2011,57,86,67,210
Oromia,East Wellega,Sibu Sire,Yekatit,6,2011,49,39,71,159
Oromia,Ilu Aba Bora,Hurumu,Tahesas,4,2011,39,13,86,138
Oromia,Qeleme Wellega,Seyo,Nehase,12,2010,75,16,65,156
Oromia,East Shewa,Liben,Nehase,12,2010,83,55,93,231
Oromia,West Wellega,Begi,Nehase,12,2009,57,50,6,113
Oromia,East Wellega,Wama Hagelo,Miyazia,8,2010,66,87,67,220
Oromia,East Shewa,Boset,Teqemt,2,2010,11,48,81,140
Oromia,East Hararge,Bedeno,Nehase,12,2010,19,64,20,103
Oromia,West Wellega,Haru,Tir,5,2011,8,73,3,84
Oromia,East Wellega,Boneya Bushe,Ginbot,9,2009,48,7,5,60
Oromia,West Wellega,Gimbi Public  Hospital,Ginbot,9,2011,6,88,71,165
Oromia,West Shewa,Gindeberet Hospital,Teqemt,2,2011,87,58,72,217
Oromia,Finfine Zuria,Berreh,Teqemt,2,2011,56,71,22,149
Oromia,South West Shewa,Tulu Bolo Hospital,Sene,10,2009,50,73,74,197
Oromia,Borena,Arero,Hamle,11,2010,45,81,24,150
Oromia,East Shewa,Adea,Tir,5,2010,63,55,10,128
Oromia,West Shewa,Nono,Miyazia,8,2011,27,1,27,55
Oromia,West Shewa,Meta Waliqite,Hamle,11,2010,73,95,65,233
Oromia,Bale,Sinana,Sene,10,2011,7,3,3,13
Oromia,West Arsi,Gedeb Asasa,Teqemt,2,2011,1,78,49,128
Oromia,Ilu Aba Bora,Algesachi,Meskerem,1,2010,47,24,49,120
Oromia,East Shewa,Olanciti Hospital,Teqemt,2,2011,54,15,48,117
Oromia,North Shewa,Yaya Gulele,Teqemt,2,2010,47,6,5,58
Oromia,North Shewa,Dera,Hamle,11,2010,89,16,86,191
Oromia,Horo Gudru Wellega,Hababo Guduru,Ginbot,9,2009,41,95,41,177
Oromia,Bale,Goba Town,Teqemt,2,2010,48,63,14,125
Oromia,Bale,Goba Town,Sene,10,2009,25,79,45,149
Oromia,Bale,Seweyna,Nehase,12,2009,65,81,54,200
Oromia,Guji,Saba Boru,Nehase,12,2009,77,67,55,199
Oromia,Ilu Aba Bora,Nono Sele,Sene,10,2010,88,95,90,273
Oromia,West Shewa,Inchini Hospital,Meskerem,1,2010,53,14,92,159
Oromia,Jimma,O/Beyam,Miyazia,8,2011,4,40,14,58
Oromia,West Hararge,Burka Dimtu,Teqemt,2,2010,85,39,99,223
Oromia,Bale,Meda Welabu,Meskerem,1,2010,95,67,12,174
Oromia,Buno Bedele,Dapho Hana,Tir,5,2011,60,11,87,158
Oromia,Finfine Zuria,Akaki,Tir,5,2011,46,83,29,158
Oromia,Jimma,Kersa,Miyazia,8,2011,29,38,5,72
Oromia,Horo Gudru Wellega,Jima Rare,Teqemt,2,2010,75,0,49,124
Oromia,North Shewa,Wuchale,Megabit,7,2010,93,16,24,133
Oromia,West Wellega,Nole Kaba,Tir,5,2009,43,97,4,144
Oromia,South West Shewa,St.Luke Hospital,Tahesas,4,2010,85,68,70,223
Oromia,Guji,Aga Wayyu,Hedar,3,2010,23,12,93,128
Oromia,West Hararge,Mesela,Ginbot,9,2011,3,25,37,65
Oromia,Bale,Dawe Serar,Miyazia,8,2010,28,51,20,99
Oromia,South West Shewa,Ameya Hospital,Ginbot,9,2011,87,23,8,118
Oromia,East Hararge,Babile Woreda,Yekatit,6,2011,41,46,87,174
Oromia,East Wellega,Haro Limu,Tir,5,2011,25,89,60,174
Oromia,Gelan Town,Gelan Town,Meskerem,1,2010,8,2,9,19
Oromia,Horo Gudru Wellega,Jima Geneti,Tir,5,2010,1,82,89,172
Oromia,North Shewa,Girar Jarso,Megabit,7,2011,1,61,55,117
Oromia,West Hararge,Daro Lebu,Yekatit,6,2010,31,84,48,163
Oromia,Burayu Town,Burayu Town,Miyazia,8,2011,40,98,20,158
Oromia,West Wellega,Mendi Hospital,Meskerem,1,2011,4,76,17,97
Oromia,Arsi,Aseko,Miyazia,8,2011,64,5,55,124
Oromia,Guji,Negele Hospital,Meskerem,1,2011,20,65,80,165
Oromia,West Wellega,Mendi Hospital,Meskerem,1,2010,79,4,80,163
Oromia,North Shewa,Girar Jarso,Yekatit,6,2010,85,11,28,124
Oromia,East Shewa,Liben,Tahesas,4,2010,95,51,75,221
Oromia,East Shewa,Boset,Sene,10,2011,72,33,38,143
Oromia,East Hararge,Kersa Eh,Sene,10,2009,98,98,2,198
Oromia,West Wellega,Nejo Rural,Yekatit,6,2010,39,54,26,119
Oromia,Finfine Zuria,Berreh,Ginbot,9,2010,41,62,44,147
Oromia,Qeleme Wellega,Gidami,Ginbot,9,2011,34,18,39,91
Oromia,West Arsi,Kore,Miyazia,8,2010,42,38,24,104
Oromia,East Shewa,Fentale,Hamle,11,2010,34,72,94,200
Oromia,East Hararge,Chinakesen,Megabit,7,2011,19,85,71,175
Oromia,Ilu Aba Bora,Bure,Nehase,12,2010,58,66,30,154
Oromia,Guji,Odo Shakiso,Miyazia,8,2011,24,95,52,171
Oromia,Horo Gudru Wellega,Gudru,Teqemt,2,2011,51,59,7,117
Oromia,Bale,Gololcha,Hedar,3,2011,13,80,26,119
Oromia,East Shewa,Adea,Megabit,7,2009,2,84,36,122
Oromia,Borena,Dilo,Megabit,7,2010,59,77,22,158
Oromia,West Wellega,Lata Sibu,Nehase,12,2010,10,85,77,172
Oromia,East Wellega,Gida Ayana,Hamle,11,2010,34,57,89,180
Oromia,West Hararge,Chiro Town,Hamle,11,2009,26,38,73,137
Oromia,Borena,Dire,Tir,5,2011,47,91,56,194
Oromia,Guji,Adola Reda,Sene,10,2009,99,69,36,204
Oromia,West Wellega,Begi Hospital,Tir,5,2010,87,56,89,232
Oromia,Burayu Town,Burayu Town,Yekatit,6,2009,90,3,94,187
Oromia,Jimma,O/Beyam,Hamle,11,2009,9,56,17,82
Oromia,Ilu Aba Bora,Yayu,Megabit,7,2010,93,92,22,207
Oromia,West Wellega,Nejo Rural,Miyazia,8,2009,3,0,1,4
Oromia,Jimma,Mana,Meskerem,1,2011,88,39,26,153
Oromia,West Wellega,Guliso,Tir,5,2011,17,6,15,38
Oromia,North Shewa,Wuchale,Sene,10,2011,18,54,46,118
Oromia,Buno Bedele,Bedele Hospital,Tir,5,2010,49,90,79,218
Oromia,Adama Special Town,Adama Town,Hamle,11,2009,58,54,20,132
Oromia,Ilu Aba Bora,Bure,Miyazia,8,2009,30,90,86,206
Oromia,Jimma,Guma,Nehase,12,2010,90,25,5,120
Oromia,South West Shewa,Seden Sodo,Teqemt,2,2011,42,15,83,140
Oromia,Guji,Aga Wayyu,Teqemt,2,2011,24,87,8,119
Oromia,East Hararge,Kurfa Chele,Ginbot,9,2011,40,4,25,69
Oromia,West Hararge,Oda Bultum,Megabit,7,2011,89,70,50,209
Oromia,Jimma,B/Tolyi,Tahesas,4,2010,21,43,74,138
Oromia,Arsi,Guna,Sene,10,2010,5,52,63,120
Oromia,East Shewa,Boset,Tir,5,2011,32,7,85,124
Oromia,Buno Bedele,Bedele Town,Ginbot,9,2011,3,93,82,178
Oromia,East Shewa,Lomme,Miyazia,8,2011,49,54,79,182
Oromia,Arsi,Shenan Kolu,Yekatit,6,2009,76,62,13,151
Oromia,East Wellega,Wama Hagelo,Miyazia,8,2009,78,16,15,109
Oromia,Bale,Legehida,Sene,10,2010,37,74,23,134
Oromia,Nekemte Town,Nekemte Town,Hamle,11,2010,30,26,33,89
Oromia,North Shewa,Degem,Hedar,3,2011,61,71,34,166
Oromia,Borena,Meyo,Nehase,12,2010,54,46,28,128
Oromia,Sebeta Town,Sebeta Town,Yekatit,6,2009,21,62,8,91
Oromia,Finfine Zuria,Walmera,Yekatit,6,2011,61,65,32,158
Oromia,West Hararge,Bedesa Town,Megabit,7,2009,89,28,60,177
Oromia,Arsi,Robe,Nehase,12,2009,76,89,72,237
Oromia,West Guji,Kercha,Yekatit,6,2011,96,54,17,167
Oromia,North Shewa,Were Jarso,Hedar,3,2010,53,80,4,137
Oromia,Bale,Delo Mena,Meskerem,1,2010,58,75,31,164
Oromia,West Wellega,Qiltu Kara,Sene,10,2011,62,26,79,167
Oromia,West Wellega,Mene Sibu,Hedar,3,2011,66,3,51,120
Oromia,East Wellega,Wama Hagelo,Miyazia,8,2010,72,64,98,234
Oromia,North Shewa,Girar Jarso,Nehase,12,2010,78,93,40,211
Oromia,East Wellega,Sibu Sire,Sene,10,2011,23,66,57,146
Oromia,Ilu Aba Bora,Hurumu,Tir,5,2010,68,38,76,182
Oromia,East Hararge,Goro Muti,Sene,10,2011,30,33,57,120
Oromia,Bale,Goba Town,Tir,5,2011,25,91,53,169
Oromia,West Wellega,Gimbi,Tir,5,2011,20,91,29,140
Oromia,Guji,Adola Hospital,Nehase,12,2010,62,27,8,97
Oromia,North Shewa,Kuyu,Teqemt,2,2010,19,12,62,93
Oromia,West Wellega,Gimbi Public  Hospital,Hedar,3,2011,3,68,95,166
Oromia,West Hararge,Oda Bultum,Hedar,3,2011,15,52,5,72
Oromia,Bale,Gasera,Miyazia,8,2011,75,91,11,177
Oromia,West Hararge,Anchar,Ginbot,9,2010,10,77,89,176
Oromia,North Shewa,Girar Jarso,Tahesas,4,2011,7,13,81,101
Oromia,East Shewa,Adama,Sene,10,2010,97,76,30,203
Oromia,East Hararge,Kombolicha,Teqemt,2,2011,17,58,9,84
Oromia,Jimma,Seka Chhokorsa Hospital,Yekatit,6,2011,16,16,71,103
Oromia,West Hararge,Burka Dimtu,Tahesas,4,2010,59,13,39,111
Oromia,Horo Gudru Wellega,Jima Rare,Miyazia,8,2009,77,90,51,218
Oromia,Finfine Zuria,Sebeta Awas,Yekatit,6,2010,8,27,26,61
Oromia,Qeleme Wellega,Yemalogi Wolel,Megabit,7,2010,26,39,22,87
Oromia,West Hararge,Mesela,Tahesas,4,2010,94,32,16,142
Oromia,Arsi,Hitosa,Ginbot,9,2011,1,80,48,129
Oromia,Nekemte Town,Nekemte Town,Tir,5,2011,38,75,20,133
Oromia,West Guji,Bule Hora,Tahesas,4,2010,29,67,80,176
Oromia,Horo Gudru Wellega,Abe Dengoro,Nehase,12,2009,12,97,85,194
Oromia,East Wellega,Jimma Arjo,Tahesas,4,2011,30,85,50,165
Oromia,West Wellega,Nejo Hospital,Ginbot,9,2009,93,19,86,198
Oromia,West Wellega,Begi,Megabit,7,2010,12,8,15,35
Oromia,Jimma,Shabe,Tir,5,2011,63,7,56,126
Oromia,North Shewa,Dera,Nehase,12,2010,63,55,30,148
Oromia,Jimma,Limu Hospital,Yekatit,6,2010,24,35,23,82
Oromia,Jimma,Dedo,Meskerem,1,2011,28,28,18,74
Oromia,West Guji,Biebirsa Kojowa,Meskerem,1,2011,64,97,25,186
Oromia,Finfine Zuria,Mullo,Hamle,11,2009,63,9,83,155
Oromia,West Arsi,Shashemene Rural,Teqemt,2,2010,5,83,60,148
Oromia,Borena,Gomole,Tir,5,2010,90,63,5,158
Oromia,Arsi,Seru,Tahesas,4,2011,95,31,84,210
Oromia,Arsi,Robe,Teqemt,2,2010,67,67,29,163
Oromia,Horo Gudru Wellega,Jima Geneti,Teqemt,2,2011,58,7,40,105
Oromia,Arsi,Tiyo,Hedar,3,2011,3,64,8,75
Oromia,East Shewa,Lomme,Tir,5,2011,69,11,24,104
Oromia,East Wellega,Gida Ayana,Hedar,3,2010,14,41,53,108
Oromia,Modjo Town,Modjo Town,Teqemt,2,2011,77,4,16,97
Oromia,West Hararge,Doba,Miyazia,8,2009,1,78,59,138
Oromia,East Wellega,Diga,Hedar,3,2011,88,12,59,159
Oromia,Borena,Yabelo,Hamle,11,2009,88,55,55,198
Oromia,Buno Bedele,Boricha,Ginbot,9,2010,12,2,8,22
Oromia,East Hararge,Meyu Muleke,Sene,10,2009,26,71,4,101
Oromia,Jimma,Guma,Miyazia,8,2011,52,26,72,150
Oromia,West Wellega,Ayira Hospital,Miyazia,8,2010,32,59,75,166
Oromia,West Guji,Dugda Dawa,Tahesas,4,2010,47,10,51,108
Oromia,East Hararge,Girawa,Ginbot,9,2010,21,94,42,157
Oromia,Bale,Berbere,Nehase,12,2009,72,16,65,153
Oromia,Jimma,Sekoru,Tahesas,4,2011,23,74,36,133
Oromia,Sebeta Town,Sebeta Town,Tahesas,4,2010,12,6,62,80
Oromia,Lege Dadi Lege Tafo Town,Lege Dadi Lege Tafo Town,Miyazia,8,2011,1,16,40,57
Oromia,Bale,Gura Dhamole,Nehase,12,2010,31,72,66,169
Oromia,East Hararge,Garemuleta Hospital,Nehase,12,2010,49,98,83,230
Oromia,West Arsi,Nensebo,Megabit,7,2010,2,47,62,111
Oromia,West Arsi,Gambo Hospital,Megabit,7,2010,88,79,71,238
Oromia,East Wellega,Wama Hagelo,Megabit,7,2010,71,85,62,218
Oromia,Sebeta Town,Sebeta Town,Miyazia,8,2010,5,68,53,126
Oromia,West Wellega,Ayira,Hamle,11,2010,67,53,53,173
Oromia,East Shewa,Gimbichu,Meskerem,1,2010,79,84,48,211
Oromia,Finfine Zuria,Holeta,Hamle,11,2009,66,99,76,241
Oromia,Qeleme Wellega,Dale Wabera,Miyazia,8,2009,17,2,51,70
Oromia,Guji,Girja,Megabit,7,2009,63,73,47,183
Oromia,East Shewa,Fentale,Megabit,7,2011,49,12,52,113
Oromia,West Shewa,Gedo Hospital,Megabit,7,2011,8,49,40,97
Oromia,Horo Gudru Wellega,Amuru,Ginbot,9,2010,26,91,48,165
Oromia,Borena,Dilo,Tahesas,4,2010,57,92,52,201
Oromia,West Wellega,Ayira Hospital,Megabit,7,2009,24,68,69,161
Oromia,North Shewa,Kuyu,Meskerem,1,2011,52,46,34,132
Oromia,West Guji,Dugda Dawa,Teqemt,2,2010,84,46,82,212
Oromia,North Shewa,Debre Libanos,Megabit,7,2011,76,11,86,173
Oromia,East Hararge,Deder,Megabit,7,2009,91,85,40,216
Oromia,West Arsi,Kokosa  Hospital,Megabit,7,2011,17,53,76,146
Oromia,West Hararge,West Harerge	Gumbi Bordede,Miyazia,8,2010,53,48,24,125
Oromia,South West Shewa,Ameya Hospital,Hamle,11,2010,75,0,45,120
Oromia,Arsi,Shirka,Miyazia,8,2010,26,45,34,105
Oromia,Horo Gudru Wellega,Shambu Town,Ginbot,9,2009,94,64,95,253
Oromia,Horo Gudru Wellega,Shambu Town,Miyazia,8,2009,7,51,48,106
Oromia,West Wellega,Qiltu Kara,Meskerem,1,2011,0,93,61,154
Oromia,Horo Gudru Wellega,Shambu Town,Teqemt,2,2011,67,66,22,155
Oromia,East Shewa,Adami Tulu Jido Kombolcha,Hedar,3,2011,51,5,78,134
Oromia,East Wellega,Guto Gida,Tahesas,4,2011,8,28,0,36
Oromia,Arsi,Dodota,Ginbot,9,2010,44,94,74,212
Oromia,Jimma,Gera,Miyazia,8,2009,81,41,39,161
Oromia,Jimma,Guma,Miyazia,8,2009,77,24,66,167
Oromia,North Shewa,Abichugna,Ginbot,9,2010,25,87,18,130
Oromia,West Hararge,West Harerge	Gumbi Bordede,Tahesas,4,2011,18,43,73,134
Oromia,East Hararge,Haromaya Rural,Miyazia,8,2009,22,0,11,33
Oromia,Arsi,Shirka,Sene,10,2009,93,91,33,217
Oromia,West Arsi,Arsi Negele Rural,Ginbot,9,2011,83,64,1,148
Oromia,North Shewa,Aleiltu,Ginbot,9,2009,89,72,82,243
Oromia,Bale,Seweyna,Sene,10,2011,0,40,58,98
Oromia,East Hararge,Haromaya Rural,Yekatit,6,2011,51,91,45,187
Oromia,South West Shewa,Sodo Dac'Ha,Teqemt,2,2010,95,91,76,262
Oromia,West Shewa,Inchini Hospital,Tir,5,2011,3,15,88,106
Oromia,West Shewa,Codi,Miyazia,8,2009,1,43,30,74
Oromia,Borena,Teltele,Teqemt,2,2010,44,7,15,66
Oromia,Borena,Gomole,Sene,10,2011,35,77,90,202
Oromia,West Shewa,Chelia,Miyazia,8,2011,89,23,79,191
Oromia,Shashamane Town,Shashamane Town,Megabit,7,2011,66,60,20,146
Oromia,Bale,Sinana,Hamle,11,2010,14,99,74,187
Oromia,Gelan Town,Gelan Town,Meskerem,1,2011,9,12,83,104
Oromia,East Shewa,Gimbichu,Megabit,7,2009,56,6,1,63
Oromia,West Shewa,Adea Berga,Megabit,7,2009,36,89,6,131
Oromia,West Arsi,Kofele,Tir,5,2009,74,37,29,140
Oromia,West Shewa,Midakegni,Ginbot,9,2009,89,98,2,189
Oromia,Buno Bedele,Dapho Hana,Teqemt,2,2010,15,71,74,160
Oromia,East Shewa,Olanciti Hospital,Megabit,7,2011,22,2,6,30
Oromia,Finfine Zuria,Sandefa,Meskerem,1,2011,90,47,44,181
Oromia,East Hararge,Girawa,Ginbot,9,2009,71,57,70,198
Oromia,Borena,Arero,Teqemt,2,2011,44,30,58,132
Oromia,West Shewa,Chelia,Sene,10,2009,66,97,56,219
Oromia,Jimma,Sigmo,Sene,10,2010,49,37,64,150
Oromia,Borena,Yabelo Rural,Nehase,12,2010,73,60,48,181
Oromia,West Wellega,Boji Cheqorsa,Sene,10,2009,30,54,85,169
Oromia,Borena,Meyo,Nehase,12,2009,12,3,81,96
Oromia,West Guji,Mkelka Soda,Meskerem,1,2010,76,61,98,235
Oromia,Finfine Zuria,Holeta,Megabit,7,2009,55,25,44,124
Oromia,West Wellega,Guliso,Tir,5,2010,98,46,97,241
Oromia,Qeleme Wellega,Yemalogi Wolel,Teqemt,2,2011,47,72,49,168
Oromia,West Shewa,Bako Hospital,Tir,5,2011,86,34,27,147
Oromia,West Guji,Bule Hora Hospital,Tir,5,2009,27,19,17,63
Oromia,Arsi,Deksis,Megabit,7,2011,48,29,6,83
Oromia,East Hararge,Midega Tole,Sene,10,2011,88,28,16,132
Oromia,Borena,Teltele,Teqemt,2,2010,76,19,42,137
Oromia,North Shewa,Wuchale,Hedar,3,2011,5,57,27,89
Oromia,West Guji,Bule Hora,Miyazia,8,2009,53,66,3,122
Oromia,East Hararge,Girawa,Megabit,7,2011,76,22,26,124
Oromia,Arsi,Limuna Bilbilo,Megabit,7,2011,49,32,43,124
Oromia,Ilu Aba Bora,Yayu,Hamle,11,2010,61,13,5,79
Oromia,West Wellega,Boji Cheqorsa,Sene,10,2009,50,49,69,168
Oromia,East Wellega,Nunu Qumba,Nehase,12,2010,74,83,61,218
Oromia,East Wellega,Kiremu,Ginbot,9,2011,42,59,0,101
Oromia,West Arsi,Gedeb Asasa,Tir,5,2010,14,10,89,113
Oromia,Jimma,Chora Boter,Teqemt,2,2011,48,85,32,165
Oromia,East Shewa,Lomme,Hedar,3,2011,45,21,62,128
Oromia,North Shewa,Abichugna,Nehase,12,2009,82,48,42,172
Oromia,Qeleme Wellega,Anfilo,Hamle,11,2009,45,50,53,148
Oromia,Arsi,Bekoji Town,Miyazia,8,2010,86,95,5,186
Oromia,Arsi,Tiyo,Megabit,7,2011,14,3,96,113
Oromia,Finfine Zuria,Sululta Town,Miyazia,8,2011,30,0,19,49
Oromia,East Hararge,Jarso,Tir,5,2009,35,51,53,139
Oromia,West Shewa,Tikur Enchini,Nehase,12,2010,60,67,67,194
Oromia,Ilu Aba Bora,Doreni,Megabit,7,2011,51,5,56,112
Oromia,Buno Bedele,Bedele Zuriya,Hedar,3,2011,66,98,70,234
Oromia,Arsi,Tena,Ginbot,9,2010,45,49,7,101
Oromia,Jimma,Limu Hospital,Ginbot,9,2009,0,52,40,92
Oromia,Ilu Aba Bora,Metu Rural,Ginbot,9,2010,63,35,6,104
Oromia,East Hararge,Goro Gutu,Hedar,3,2010,48,7,78,133
Oromia,Guji,Adola Town,Hamle,11,2009,35,36,11,82
Oromia,Guji,Aga Wayyu,Nehase,12,2009,56,12,53,121
Oromia,Borena,Guchi,Megabit,7,2009,33,78,53,164
Oromia,West Guji,Bule Hora,Megabit,7,2010,58,70,29,157
Oromia,South West Shewa,Ameya Hospital,Hamle,11,2010,66,62,72,200
Oromia,Bale,Gura Dhamole,Teqemt,2,2011,75,26,82,183
Oromia,West Shewa,Abuna Gindeberet,Yekatit,6,2009,87,10,1,98
Oromia,West Shewa,Midakegni,Tir,5,2009,82,98,20,200
Oromia,Finfine Zuria,Sandefa,Ginbot,9,2009,8,0,5,13
Oromia,West Wellega,Mene Sibu,Hedar,3,2011,61,45,2,108
Oromia,Ilu Aba Bora,Nono Sele,Nehase,12,2009,83,58,95,236
Oromia,Bale,Goba Town,Sene,10,2010,28,10,74,112
Oromia,Borena,Yabelo Rural,Sene,10,2009,74,83,29,186
Oromia,Guji,Adola Reda,Sene,10,2010,39,10,52,101
Oromia,West Arsi,Dodola Town,Teqemt,2,2011,29,46,5,80
Oromia,West Hararge,Tulo,Hamle,11,2010,81,85,63,229
Oromia,Finfine Zuria,Sebeta Awas,Ginbot,9,2010,97,62,74,233
Oromia,East Wellega,Ebantu,Megabit,7,2010,12,13,89,114
Oromia,Finfine Zuria,Berreh,Yekatit,6,2011,91,59,54,204
Oromia,Jimma Spe Town,Jimma Spe Town,Teqemt,2,2011,58,1,26,85
Oromia,Jimma,Shabe,Megabit,7,2010,10,90,62,162
Oromia,West Wellega,Seyo Nole,Hamle,11,2010,8,0,21,29
Oromia,West Wellega,Boji Dermeji,Miyazia,8,2011,92,62,43,197
Oromia,West Guji,Bule Hora Hospital,Miyazia,8,2009,27,54,0,81
Oromia,West Wellega,Lalo Asabi,Sene,10,2011,42,18,3,63
Oromia,Borena,Moyale Hospital,Ginbot,9,2011,27,62,49,138
Oromia,Arsi,Bale Gesgara,Megabit,7,2010,66,4,20,90
Oromia,East Shewa,Lomme,Hedar,3,2011,52,86,24,162
Oromia,West Wellega,Mendi Hospital,Yekatit,6,2010,88,65,18,171
Oromia,Arsi,Sude,Sene,10,2010,28,67,35,130
Oromia,East Wellega,Guto Gida,Yekatit,6,2010,26,51,65,142
Oromia,Guji,Goro Dola,Hamle,11,2010,99,83,2,184
Oromia,West Wellega,Guliso,Ginbot,9,2011,16,23,80,119
Oromia,Guji,Gumi Eldallo,Sene,10,2011,8,70,38,116
Oromia,Guji,Adola Town,Nehase,12,2010,13,21,72,106
Oromia,West Wellega,Haru,Yekatit,6,2009,7,85,98,190
Oromia,East Hararge,Girawa,Teqemt,2,2011,18,32,56,106
Oromia,West Hararge,Daro Lebu,Megabit,7,2009,8,48,76,132
Oromia,Arsi,Aseko,Ginbot,9,2009,25,49,13,87
Oromia,Qeleme Wellega,Jimma Horo,Sene,10,2010,19,69,2,90
Oromia,Arsi,Aseko,Hedar,3,2011,7,12,58,77
Oromia,East Shewa,Fentale,Hamle,11,2009,33,94,1,128
Oromia,Horo Gudru Wellega,Horo,Sene,10,2009,69,6,93,168
Oromia,Guji,Wadara,Yekatit,6,2011,3,93,25,121
Oromia,East Hararge,Bisidimo Hospital,Hedar,3,2010,61,17,87,165
Oromia,West Arsi,Dodola Town,Megabit,7,2010,80,85,62,227
Oromia,Robe Town,Robe Town,Tir,5,2011,52,79,1,132
Oromia,West Guji,Dugda Dawa,Megabit,7,2011,7,38,68,113
Oromia,Arsi,Ludehetosa,Sene,10,2009,60,48,39,147
Oromia,Arsi,Chole,Hedar,3,2010,14,22,41,77
Oromia,Jimma,Nono Benja,Meskerem,1,2010,44,87,14,145
Oromia,Guji,Negele Town,Megabit,7,2009,87,77,92,256
Oromia,South West Shewa,Woliso Rural,Megabit,7,2009,28,38,35,101
Oromia,West Wellega,Gimbi,Hamle,11,2010,39,40,18,97
Oromia,Bale,Delo Mena,Megabit,7,2010,66,48,4,118
Oromia,Qeleme Wellega,Laloqile,Nehase,12,2010,16,52,25,93
Oromia,Borena,Moyale,Yekatit,6,2009,13,44,56,113
Oromia,North Shewa,Degem,Yekatit,6,2011,76,78,87,241
Oromia,Ilu Aba Bora,Doreni,Hamle,11,2009,2,86,2,90
Oromia,West Shewa,Dendi,Yekatit,6,2010,97,67,60,224
Oromia,South West Shewa,Seden Sodo,Hedar,3,2010,78,88,79,245
Oromia,South West Shewa,Ameya,Ginbot,9,2009,36,53,1,90
Oromia,North Shewa,Wuchale,Tahesas,4,2011,35,4,30,69
Oromia,Bale,Delo Mena,Megabit,7,2009,5,55,55,115
Oromia,Guji,Gumi Eldallo,Tahesas,4,2010,80,12,46,138
Oromia,Arsi,Enkelo Wabe,Hamle,11,2009,81,90,72,243
Oromia,North Shewa,Dera,Hedar,3,2010,4,51,33,88
Oromia,West Hararge,Chiro Town,Miyazia,8,2009,29,99,68,196
Oromia,South West Shewa,Dawo,Tir,5,2009,74,8,80,162
Oromia,Robe Town,Robe Town,Hedar,3,2010,69,55,39,163
Oromia,East Wellega,Gobu Seyo,Nehase,12,2010,32,97,3,132
Oromia,South West Shewa,Sodo Dac'Ha,Meskerem,1,2011,48,95,26,169
Oromia,East Wellega,Ebantu,Megabit,7,2011,18,53,21,92
Oromia,North Shewa,Debre Libanos,Sene,10,2009,2,81,83,166
Oromia,East Hararge,Deder Town,Tir,5,2011,82,96,18,196
Oromia,Guji,Bore,Ginbot,9,2011,1,45,37,83
Oromia,East Shewa,Fentale,Hamle,11,2010,52,54,30,136
Oromia,Arsi,Chole,Ginbot,9,2011,17,22,19,58
Oromia,West Arsi,Dodola  Hospital,Miyazia,8,2011,63,87,33,183
Oromia,West Hararge,Oda Bultum,Tahesas,4,2011,53,97,35,185
Oromia,West Arsi,Kokosa  Hospital,Miyazia,8,2010,2,28,30,60
Oromia,Bale,Dawe Serar,Tahesas,4,2010,5,23,2,30
Oromia,Guji,Odo Shakiso,Ginbot,9,2010,20,63,13,96
Oromia,Ilu Aba Bora,Halu,Megabit,7,2010,51,0,39,90
Oromia,Jimma,Limu Kosa,Tahesas,4,2010,10,9,9,28
Oromia,West Hararge,Hawi Gudina,Sene,10,2009,24,86,2,112
Oromia,Jimma,Sekoru,Tir,5,2010,18,34,53,105
Oromia,Jimma,Agaro Hospital,Ginbot,9,2011,83,86,22,191
Oromia,Jimma,Shabe,Miyazia,8,2011,8,1,43,52
Oromia,Bale,Goba,Megabit,7,2011,55,69,6,130
Oromia,West Shewa,Nono,Miyazia,8,2009,72,31,27,130
Oromia,East Hararge,Meta,Miyazia,8,2011,15,99,95,209
Oromia,Horo Gudru Wellega,Gudru,Hedar,3,2010,94,85,91,270
Oromia,West Shewa,Gedo Hospital,Yekatit,6,2010,32,38,55,125
Oromia,Guji,Adola Town,Meskerem,1,2011,17,80,95,192
Oromia,Arsi,Enkelo Wabe,Hedar,3,2011,14,5,94,113
Oromia,East Hararge,Chelenko Hospital,Hedar,3,2011,99,80,47,226
Oromia,Qeleme Wellega,Dale Sedi,Miyazia,8,2011,37,79,15,131
Oromia,West Shewa,Gojo Hospital,Tahesas,4,2010,43,96,49,188
Oromia,West Arsi,Siraro,Megabit,7,2010,69,84,44,197
Oromia,Arsi,Shirka,Meskerem,1,2011,16,25,30,71
Oromia,South West Shewa,St.Luke Hospital,Tahesas,4,2011,52,87,97,236
Oromia,Ilu Aba Bora,Didu,Yekatit,6,2011,99,72,58,229
Oromia,West Shewa,Tibe Kutaye,Tahesas,4,2010,59,62,28,149
Oromia,Ilu Aba Bora,Darimu,Hedar,3,2011,58,79,42,179
Oromia,Arsi,Deksis,Sene,10,2010,92,16,27,135
Oromia,West Hararge,Oda Bultum,Nehase,12,2009,62,77,21,160
Oromia,Bale,Gasera,Teqemt,2,2010,57,75,4,136
Oromia,South West Shewa,Dawo,Miyazia,8,2009,0,34,23,57
Oromia,East Hararge,Babile,Megabit,7,2011,8,21,98,127
Oromia,West Guji,Abaya,Sene,10,2009,44,97,90,231
Oromia,Jimma,Seka Chhokorsa Hospital,Meskerem,1,2011,12,16,68,96
Oromia,Qeleme Wellega,Yemalogi Wolel,Teqemt,2,2011,80,35,23,138
Oromia,South West Shewa,Tole,Tir,5,2011,25,40,0,65
Oromia,West Shewa,Ejersa Lafo,Tahesas,4,2011,48,55,95,198
Oromia,Arsi,Deksis,Tir,5,2010,93,23,95,211
Oromia,West Shewa,Gindeberet Hospital,Tahesas,4,2011,35,34,71,140
Oromia,North Shewa,Kuyu Hospital,Tir,5,2011,69,68,77,214
Oromia,Ilu Aba Bora,Ale,Teqemt,2,2011,26,94,52,172
Oromia,Ilu Aba Bora,Bure,Tir,5,2011,8,51,8,67
Oromia,South West Shewa,Wonchi,Ginbot,9,2010,38,88,39,165
Oromia,East Shewa,Olanciti Hospital,Hedar,3,2011,10,14,33,57
Oromia,East Hararge,Haromaya Hospital,Miyazia,8,2010,18,25,2,45
Oromia,North Shewa,Jido,Teqemt,2,2011,18,87,64,169
Oromia,Sululta Town,Sululta Town,Teqemt,2,2010,34,67,73,174
Oromia,Jimma,Shabe,Ginbot,9,2011,17,73,0,90
Oromia,Arsi,Tiyo,Tir,5,2010,12,95,19,126
Oromia,North Shewa,Degem,Yekatit,6,2010,92,48,87,227
Oromia,West Wellega,Lata Sibu,Megabit,7,2010,77,81,46,204
Oromia,East Wellega,Boneya Bushe,Miyazia,8,2010,84,8,42,134
Oromia,West Wellega,Lata Sibu,Sene,10,2010,28,62,24,114
Oromia,East Hararge,Deder Town,Nehase,12,2009,54,12,29,95
Oromia,Buno Bedele,Bedele Zuriya,Tir,5,2011,45,57,20,122
Oromia,Borena,El Way,Tahesas,4,2011,13,31,5,49
Oromia,Jimma,Agaro Hospital,Tahesas,4,2011,73,53,61,187
Oromia,West Wellega,Begi Hospital,Miyazia,8,2010,65,76,15,156
Oromia,East Hararge,Babile Woreda,Tahesas,4,2010,52,65,19,136
Oromia,Qeleme Wellega,Dambi Dolo Hospital,Nehase,12,2009,56,16,22,94
Oromia,West Guji,Kercha,Meskerem,1,2011,32,41,36,109
Oromia,South West Shewa,Goro,Miyazia,8,2010,92,80,68,240
Oromia,East Shewa,Batu,Yekatit,6,2011,3,0,10,13
Oromia,East Hararge,Bedeno,Hedar,3,2011,9,73,24,106
Oromia,West Shewa,Bako Hospital,Hamle,11,2010,38,25,58,121
Oromia,Jimma,Seka Chekorsa,Ginbot,9,2009,5,76,25,106
Oromia,West Shewa,Ejersa Lafo,Yekatit,6,2009,35,46,65,146
Oromia,Finfine Zuria,Walmera,Nehase,12,2010,86,86,5,177
Oromia,Borena,Moyale,Teqemt,2,2010,14,45,16,75
Oromia,West Shewa,Gojo Hospital,Tahesas,4,2010,74,12,28,114
Oromia,West Guji,Hanbala,Hedar,3,2010,23,55,44,122
Oromia,West Wellega,Begi Hospital,Hedar,3,2010,61,7,74,142
Oromia,North Shewa,Fiche Hospital,Megabit,7,2009,19,6,69,94
Oromia,West Shewa,Nono,Miyazia,8,2009,45,52,95,192
Oromia,East Shewa,Dugda,Teqemt,2,2010,83,22,17,122
Oromia,Buno Bedele,Bedele Hospital,Meskerem,1,2011,68,30,46,144
Oromia,East Wellega,Boneya Bushe,Hedar,3,2010,74,11,58,143
Oromia,East Wellega,Haro Limu,Megabit,7,2011,40,55,70,165
Oromia,North Shewa,Were Jarso,Ginbot,9,2011,19,19,61,99
Oromia,West Guji,Bule Hora,Teqemt,2,2011,63,39,0,102
Oromia,West Wellega,Nejo Rural,Tahesas,4,2010,18,39,95,152
Oromia,West Wellega,Lata Sibu,Ginbot,9,2011,27,9,98,134
Oromia,East Wellega,Guto Gida,Tahesas,4,2011,75,74,30,179
Oromia,West Arsi,Bishan Guracha Town,Tir,5,2010,41,73,59,173
Oromia,Horo Gudru Wellega,Jarte Jardga,Hedar,3,2010,48,6,6,60
Oromia,Guji,Aga Wayyu,Sene,10,2009,95,83,85,263
Oromia,Borena,Yabelo Hospital,Hedar,3,2010,54,75,50,179
Oromia,Ilu Aba Bora,Algesachi,Meskerem,1,2011,20,56,23,99
Oromia,West Wellega,Nole Kaba,Tahesas,4,2010,74,97,89,260
Oromia,Arsi,Merti,Tir,5,2010,42,25,9,76
Oromia,East Shewa,Olanciti Hospital,Ginbot,9,2011,23,46,9,78
Oromia,Jimma,Omo Nada Hospital,Hamle,11,2010,70,67,56,193
Oromia,West Shewa,Elifata,Hedar,3,2011,8,21,65,94
Oromia,East Shewa,Batu,Nehase,12,2010,66,50,92,208
Oromia,Buno Bedele,Boricha,Meskerem,1,2011,31,37,21,89
Oromia,Sululta Town,Sululta Town,Tir,5,2009,75,43,18,136
Oromia,North Shewa,Fiche Hospital,Nehase,12,2009,56,32,58,146
Oromia,East Hararge,Bisidimo Hospital,Yekatit,6,2011,26,35,33,94
Oromia,East Hararge,Bedeno,Nehase,12,2010,89,45,49,183
Oromia,Guji,Gumi Eldallo,Hedar,3,2010,42,37,63,142
Oromia,Arsi,Bekoji Town,Megabit,7,2010,55,7,64,126
Oromia,West Hararge,Burka Dimtu,Megabit,7,2011,27,69,12,108
Oromia,West Shewa,Metarobi,Yekatit,6,2011,17,29,74,120
Oromia,Arsi,Jeju,Teqemt,2,2010,43,86,86,215
Oromia,East Wellega,Gida Ayana,Nehase,12,2009,15,50,14,79
Oromia,East Wellega,Diga,Meskerem,1,2010,69,76,70,215
Oromia,South West Shewa,Becho,Ginbot,9,2011,67,45,80,192
Oromia,West Guji,Abaya,Yekatit,6,2011,51,95,90,236
Oromia,East Hararge,Chelenko Hospital,Yekatit,6,2010,41,52,10,103
Oromia,South West Shewa,Ameya,Yekatit,6,2010,9,67,98,174
Oromia,West Guji,Mkelka Soda,Megabit,7,2009,10,65,27,102
Oromia,Jimma,B/Tolyi,Tahesas,4,2010,66,48,24,138
Oromia,West Hararge,Hawi Gudina,Nehase,12,2010,54,22,10,86
Oromia,Buno Bedele,Bedele Zuriya,Sene,10,2011,45,15,27,87
Oromia,West Shewa,Dendi,Hedar,3,2010,87,58,50,195
Oromia,Borena,Dilo,Tir,5,2010,35,76,66,177
Oromia,East Shewa,Batu,Yekatit,6,2009,12,9,31,52
Oromia,West Arsi,Kore,Hamle,11,2010,93,0,88,181
Oromia,Arsi,Aseko,Tir,5,2010,83,16,72,171
Oromia,North Shewa,Degem,Sene,10,2009,7,6,5,18
Oromia,West Wellega,Qiltu Kara,Nehase,12,2009,82,44,49,175
Oromia,West Wellega,Genji,Hedar,3,2010,9,69,94,172
Oromia,Horo Gudru Wellega,Shambu Hospital,Megabit,7,2011,68,85,53,206
Oromia,North Shewa,Aleiltu,Tahesas,4,2011,77,3,54,134
Oromia,West Shewa,Meta Waliqite,Tir,5,2010,11,50,24,85
Oromia,Ilu Aba Bora,Algesachi,Tir,5,2009,28,29,59,116
Oromia,West Shewa,Elifata,Megabit,7,2009,63,85,50,198
Oromia,Ilu Aba Bora,Nono Sele,Meskerem,1,2011,20,42,90,152
Oromia,West Arsi,Dodola Town,Hamle,11,2009,71,4,79,154
Oromia,West Shewa,Guder Hosp,Miyazia,8,2011,77,16,89,182
Oromia,East Hararge,Garemuleta Hospital,Hedar,3,2011,6,54,42,102
Oromia,West Shewa,Gindeberet Hospital,Hedar,3,2010,13,1,14,28
Oromia,East Hararge,Babile Woreda,Miyazia,8,2010,96,38,52,186
Oromia,Arsi,Dodota,Hamle,11,2010,28,24,18,70
Oromia,Qeleme Wellega,Jimma Horo,Hedar,3,2010,15,57,70,142
Oromia,North Shewa,Were Jarso,Megabit,7,2009,0,71,9,80
Oromia,Buno Bedele,Bedele Zuriya,Ginbot,9,2010,18,82,60,160
Oromia,Shashamane Town,Shashamane Town,Meskerem,1,2011,2,31,94,127
Oromia,East Wellega,Wama Hagelo,Megabit,7,2011,67,61,66,194
Oromia,Guji,Aga Wayyu,Megabit,7,2011,37,37,65,139
Oromia,Guji,Aga Wayyu,Nehase,12,2009,11,48,39,98
Oromia,Jimma,Omo Nada Hospital,Tahesas,4,2011,60,22,38,120
Oromia,Arsi,Sude,Yekatit,6,2009,45,8,22,75
Oromia,Arsi,Deksis,Teqemt,2,2011,42,10,56,108
Oromia,Jimma,Agaro,Nehase,12,2010,36,57,91,184
Oromia,Horo Gudru Wellega,Gudru,Tir,5,2011,73,96,5,174
Oromia,East Wellega,Wama Hagelo,Tir,5,2010,88,98,71,257
Oromia,Bale,Seweyna,Hamle,11,2009,3,40,20,63
Oromia,West Hararge,Bedesa Town,Meskerem,1,2010,89,25,89,203
Oromia,West Shewa,Dendi,Megabit,7,2010,12,12,93,117
Oromia,East Hararge,Bisidimo Hospital,Nehase,12,2009,76,95,25,196
Oromia,Bale,Gasera,Megabit,7,2009,0,58,84,142
Oromia,Guji,Hambela Wamena,Meskerem,1,2011,16,49,67,132
Oromia,Bale,Dawe Qachen,Yekatit,6,2010,42,33,86,161
Oromia,West Wellega,Boji Cheqorsa,Miyazia,8,2011,87,1,57,145
Oromia,West Shewa,Guder Hosp,Teqemt,2,2010,6,3,87,96
Oromia,West Shewa,Dano,Teqemt,2,2010,44,7,6,57
Oromia,Borena,El Way,Hedar,3,2011,98,1,20,119
Oromia,Jimma,Mana,Tir,5,2009,3,27,85,115
Oromia,West Hararge,Burka Dimtu,Megabit,7,2009,19,21,9,49
Oromia,East Shewa,Liben,Tahesas,4,2010,82,12,85,179
Oromia,Bale,Meda Welabu,Hamle,11,2009,51,30,34,115
Oromia,East Shewa,Lomme,Hedar,3,2010,78,47,39,164
Oromia,East Hararge,Bedeno,Meskerem,1,2011,14,8,49,71
Oromia,West Wellega,Ayira,Hedar,3,2010,50,47,61,158
Oromia,North Shewa,Degem,Ginbot,9,2010,84,76,23,183
Oromia,Jimma,Mancho,Megabit,7,2011,44,22,30,96
Oromia,West Shewa,Dendi,Miyazia,8,2009,18,88,81,187
Oromia,West Wellega,Begi Hospital,Yekatit,6,2010,91,79,23,193
Oromia,Horo Gudru Wellega,Jima Rare,Hedar,3,2010,19,98,72,189
Oromia,Arsi,Digeluna Tijo,Tir,5,2010,23,18,57,98
Oromia,Jimma,Setema,Miyazia,8,2009,16,13,38,67
Oromia,East Hararge,Fedis,Tir,5,2010,65,76,68,209
Oromia,Ambo Town,Ambo Town,Hamle,11,2010,58,92,21,171
Oromia,Qeleme Wellega,Dale Sedi,Meskerem,1,2011,25,86,1,112
Oromia,South West Shewa,St.Luke Hospital,Ginbot,9,2010,89,1,45,135
Oromia,East Hararge,Garemuleta Hospital,Miyazia,8,2010,26,49,73,148
Oromia,West Wellega,Yubdo,Megabit,7,2009,30,66,83,179
Oromia,East Hararge,Deder Town,Miyazia,8,2009,40,90,1,131
Oromia,North Shewa,Dera,Miyazia,8,2009,25,77,50,152
Oromia,Borena,Dilo,Megabit,7,2011,1,57,50,108
Oromia,West Arsi,Gambo Hospital,Yekatit,6,2011,21,77,5,103
Oromia,Horo Gudru Wellega,Horro Buluk,Miyazia,8,2011,7,88,77,172
Oromia,East Hararge,Chelenko Hospital,Miyazia,8,2009,74,55,15,144
Oromia,Buno Bedele,Dedesa,Miyazia,8,2010,59,55,59,173
Oromia,West Arsi,Dodola Rural,Ginbot,9,2011,14,28,13,55
Oromia,West Shewa,Meta Waliqite,Megabit,7,2010,59,71,33,163
Oromia,Qeleme Wellega,Dambi Dollo,Yekatit,6,2010,56,55,66,177
Oromia,Ambo Town,Ambo Town,Yekatit,6,2011,74,85,35,194
Oromia,Ilu Aba Bora,Ale,Sene,10,2009,77,83,77,237
Oromia,Borena,Gomole,Meskerem,1,2010,85,79,94,258
Oromia,West Hararge,Guba Qoricha,Meskerem,1,2011,34,9,89,132
Oromia,East Wellega,Boneya Bushe,Tahesas,4,2011,37,13,72,122
Oromia,Ilu Aba Bora,Becho,Miyazia,8,2011,81,83,58,222
Oromia,South West Shewa,Wonchi,Tir,5,2009,49,80,16,145
Oromia,West Arsi,Adaba,Nehase,12,2009,85,21,1,107
Oromia,West Arsi,Kofele,Megabit,7,2011,44,69,6,119
Oromia,Guji,Negele Hospital,Hedar,3,2011,20,93,29,142
Oromia,West Arsi,Shashemene Rural,Teqemt,2,2011,8,35,89,132
Oromia,West Guji,Bule Hora Hospital,Miyazia,8,2010,31,82,93,206
Oromia,Arsi,Dodota,Hedar,3,2011,11,95,40,146
Oromia,Borena,Dhas,Miyazia,8,2010,29,77,40,146
Oromia,Bale,Dawe Qachen,Meskerem,1,2011,33,56,3,92
Oromia,North Shewa,Degem,Miyazia,8,2010,52,53,76,181
Oromia,Arsi,Chole,Tahesas,4,2011,31,34,34,99
Oromia,East Shewa,Dugda,Teqemt,2,2011,78,47,5,130
Oromia,East Hararge,Fedis,Teqemt,2,2011,83,80,16,179
Oromia,West Arsi,Gambo Hospital,Sene,10,2009,25,93,86,204
Oromia,Borena,Dhas,Meskerem,1,2010,33,87,20,140
Oromia,East Wellega,Leqa Dulecha,Nehase,12,2010,71,2,15,88
Oromia,West Wellega,Genji,Hamle,11,2009,83,13,95,191
Oromia,Finfine Zuria,Akaki,Megabit,7,2009,87,20,22,129
Oromia,East Hararge,Chinakesen,Sene,10,2009,92,72,79,243
Oromia,East Wellega,Gida Ayana,Sene,10,2010,73,37,82,192
Oromia,Woliso Town,Woliso Town,Meskerem,1,2011,64,12,24,100
Oromia,West Wellega,Lalo Asabi,Nehase,12,2009,27,22,85,134
Oromia,East Wellega,Wayu Tuqa,Hamle,11,2010,6,87,44,137
Oromia,East Hararge,Aweday Town,Ginbot,9,2009,51,34,52,137
Oromia,East Hararge,Girawa,Hedar,3,2011,0,2,72,74
Oromia,Ilu Aba Bora,Ale,Ginbot,9,2011,48,86,22,156
Oromia,West Arsi,Bishan Guracha Town,Meskerem,1,2011,54,16,70,140
Oromia,East Shewa,Matahara,Nehase,12,2009,7,31,21,59
Oromia,West Wellega,Ayira,Teqemt,2,2010,97,52,39,188
Oromia,Finfine Zuria,Holeta,Teqemt,2,2010,23,49,9,81
Oromia,West Shewa,Abuna Gindeberet,Meskerem,1,2010,70,65,73,208
Oromia,Jimma,Chora Boter,Tir,5,2011,12,75,76,163
Oromia,East Wellega,Haro Limu,Tir,5,2010,63,79,78,220
Oromia,East Hararge,Babile,Tir,5,2011,45,66,38,149
Oromia,Arsi,Dodota,Tir,5,2010,35,15,75,125
Oromia,West Hararge,Chiro Zuriya,Megabit,7,2009,53,43,93,189
Oromia,Bale,Delo Mena,Hamle,11,2009,60,84,82,226
Oromia,Horo Gudru Wellega,Abe Dengoro,Tir,5,2010,52,83,50,185
Oromia,Arsi,Tiyo,Ginbot,9,2010,14,14,94,122
Oromia,Guji,Shakiso Town,Sene,10,2011,44,58,98,200
Oromia,Buno Bedele,Bedele Zuriya,Sene,10,2009,99,15,87,201
Oromia,East Hararge,Aweday Town,Yekatit,6,2010,74,30,5,109
Oromia,Horo Gudru Wellega,Gudru,Nehase,12,2010,1,30,50,81
Oromia,West Hararge,Boke,Hedar,3,2011,31,1,46,78
Oromia,Jimma,Agaro Hospital,Ginbot,9,2011,49,0,75,124
Oromia,Horo Gudru Wellega,Amuru,Megabit,7,2009,95,80,99,274
Oromia,East Hararge,Meta,Tir,5,2009,23,12,92,127
Oromia,West Hararge,Doba,Sene,10,2011,26,16,7,49
Oromia,West Guji,Abaya,Hedar,3,2010,57,11,36,104
Oromia,Arsi,Tena,Megabit,7,2010,14,24,42,80
Oromia,West Guji,Bule Hora Toun,Meskerem,1,2011,70,44,55,169
Oromia,Jimma,Sigmo,Meskerem,1,2010,83,23,33,139
Oromia,East Hararge,Aweday Town,Yekatit,6,2010,77,40,30,147
Oromia,West Shewa,Gindeberet Hospital,Megabit,7,2010,87,81,5,173
Oromia,Arsi,Guna,Yekatit,6,2010,17,53,23,93
Oromia,East Wellega,Sasiga,Yekatit,6,2011,81,12,49,142
Oromia,Borena,Moyale Hospital,Hamle,11,2010,34,75,55,164
Oromia,Guji,Bore,Miyazia,8,2009,12,40,50,102
Oromia,Shashamane Town,Shashamane Town,Hamle,11,2010,51,26,27,104
Oromia,East Hararge,Goro Muti,Sene,10,2009,26,86,61,173
Oromia,East Shewa,Dugda,Sene,10,2010,0,71,68,139
Oromia,East Wellega,Gida Ayana,Tir,5,2010,33,19,82,134
Oromia,West Hararge,Chiro Hospital,Hamle,11,2010,15,37,61,113
Oromia,West Wellega,Boji Cheqorsa,Miyazia,8,2011,88,39,2,129
Oromia,East Wellega,Wayu Tuqa,Yekatit,6,2009,14,14,82,110
Oromia,West Shewa,Jeldu,Hamle,11,2009,11,55,16,82
Oromia,West Shewa,Jibat,Miyazia,8,2009,19,2,65,86
Oromia,Jimma,Kersa,Hedar,3,2011,85,58,64,207
Oromia,Guji,Negele Hospital,Hedar,3,2010,4,68,83,155
Oromia,East Wellega,Wayu Tuqa,Ginbot,9,2009,26,88,24,138
Oromia,Bale,Raitu,Teqemt,2,2011,33,25,61,119
Oromia,South West Shewa,Seden Sodo,Tir,5,2010,15,96,25,136
Oromia,South West Shewa,Goro,Miyazia,8,2009,82,31,55,168
Oromia,Jimma,Mana,Yekatit,6,2009,10,11,87,108
Oromia,Jimma,Limu Kosa,Hedar,3,2010,36,14,18,68
Oromia,Buno Bedele,Chewaqa,Ginbot,9,2009,15,59,30,104
Oromia,West Hararge,Hawi Gudina,Tir,5,2011,68,87,20,175
Oromia,West Guji,Bule Hora Hospital,Teqemt,2,2010,14,74,28,116
Oromia,Ilu Aba Bora,Nono Sele,Ginbot,9,2010,17,61,9,87
Oromia,Arsi,Gololcha,Miyazia,8,2011,92,0,60,152
Oromia,West Wellega,Babo Gembel,Ginbot,9,2011,88,3,24,115
Oromia,West Arsi,Loke Hada Hospital,Tahesas,4,2011,65,17,65,147
Oromia,West Wellega,Gimbi Adventist Hospital,Megabit,7,2009,13,11,75,99
Oromia,Guji,Wadara,Sene,10,2009,30,43,1,74
Oromia,Jimma,Gomma,Ginbot,9,2011,95,94,9,198
Oromia,Ilu Aba Bora,Bilonopa,Meskerem,1,2010,86,16,45,147
Oromia,Borena,Dubluk,Tahesas,4,2011,47,35,96,178
Oromia,East Hararge,Haromaya Town,Yekatit,6,2009,54,38,43,135
Oromia,East Hararge,Melka Belo,Miyazia,8,2011,39,59,40,138
Oromia,East Wellega,Sasiga,Megabit,7,2010,8,20,9,37
Oromia,Gelan Town,Gelan Town,Teqemt,2,2010,50,53,89,192
Oromia,West Hararge,Mesela,Tahesas,4,2011,6,37,68,111
Oromia,North Shewa,Hidabu Abote,Teqemt,2,2010,1,5,85,91
Oromia,Finfine Zuria,Sandefa,Tahesas,4,2011,7,50,72,129
Oromia,Bale,Berbere,Miyazia,8,2011,44,14,83,141
Oromia,West Hararge,Guba Qoricha,Hamle,11,2010,97,87,41,225
Oromia,East Hararge,Goro Gutu,Sene,10,2010,70,64,27,161
Oromia,West Guji,Abaya,Tir,5,2011,93,51,74,218
Oromia,West Arsi,Dodola Rural,Ginbot,9,2011,63,9,21,93
Oromia,South West Shewa,Ameya Hospital,Nehase,12,2010,89,73,27,189
Oromia,Qeleme Wellega,Laloqile,Teqemt,2,2010,86,79,30,195
Oromia,Buno Bedele,Bedele Hospital,Tahesas,4,2010,35,75,4,114
Oromia,Buno Bedele,Dedesa,Hamle,11,2010,59,59,3,121
Oromia,West Wellega,Mendi Hospital,Teqemt,2,2011,4,4,14,22
Oromia,Borena,Teltele,Hedar,3,2010,58,68,92,218
Oromia,West Shewa,Chelia,Tir,5,2011,41,31,85,157
Oromia,East Wellega,Diga,Yekatit,6,2009,80,44,24,148
Oromia,Horo Gudru Wellega,Shambu Hospital,Hedar,3,2011,32,29,1,62
Oromia,West Arsi,Nensebo,Meskerem,1,2011,43,64,44,151
Oromia,Finfine Zuria,Berreh,Yekatit,6,2011,21,52,73,146
Oromia,West Hararge,Habro,Megabit,7,2010,56,36,23,115
Oromia,Jimma,Tiro Afeta,Miyazia,8,2011,13,58,20,91
Oromia,West Arsi,Bishan Guracha Town,Tir,5,2009,40,85,27,152
Oromia,Adama Special Town,Adama Town,Hedar,3,2010,93,95,53,241
Oromia,North Shewa,Kimbibit,Teqemt,2,2010,63,3,9,75
Oromia,West Arsi,Shala,Ginbot,9,2011,26,44,64,134
Oromia,Jimma,Dedo,Megabit,7,2011,1,89,16,106
Oromia,Guji,Uraga,Tir,5,2011,8,21,23,52
Oromia,Bale,Goro,Hedar,3,2011,71,81,16,168
Oromia,Ilu Aba Bora,Yayu,Tir,5,2009,45,61,59,165
Oromia,South West Shewa,Sodo Dac'Ha,Miyazia,8,2009,74,10,39,123
Oromia,North Shewa,Abichugna,Nehase,12,2009,76,14,42,132
Oromia,West Shewa,Ambo Town,Meskerem,1,2010,67,52,16,135
Oromia,West Guji,Bule Hora Toun,Hedar,3,2010,42,63,53,158
Oromia,Buno Bedele,Meko,Nehase,12,2010,12,46,80,138
Oromia,West Wellega,Guliso,Sene,10,2011,8,63,43,114
Oromia,Bale,Gasera,Teqemt,2,2011,54,18,28,100
Oromia,East Hararge,Bisidimo Hospital,Tahesas,4,2010,71,5,90,166
Oromia,South West Shewa,Dawo,Teqemt,2,2011,98,3,9,110
Oromia,East Wellega,Ebantu,Sene,10,2010,96,46,75,217
Oromia,Horo Gudru Wellega,Jarte Jardga,Sene,10,2011,5,69,90,164
Oromia,East Hararge,Gole Oda,Ginbot,9,2011,17,45,98,160
Oromia,West Wellega,Seyo Nole,Ginbot,9,2011,94,96,82,272
Oromia,Jimma,O/Beyam,Nehase,12,2010,23,7,56,86
Oromia,Arsi,Shenan Kolu,Teqemt,2,2010,41,94,96,231
Oromia,West Arsi,Kore,Yekatit,6,2010,57,64,61,182
Oromia,North Shewa,Fichetown,Ginbot,9,2010,76,2,43,121
Oromia,Sebeta Town,Sebeta Town,Ginbot,9,2009,33,10,9,52
Oromia,East Wellega,Guto Gida,Megabit,7,2010,27,81,46,154
Oromia,West Shewa,Ginde Beret,Ginbot,9,2011,85,67,97,249
Oromia,East Hararge,Babile,Hedar,3,2011,52,71,79,202
Oromia,Borena,Yabelo,Tir,5,2009,93,11,84,188
Oromia,Bale,Ginir Town,Miyazia,8,2009,84,93,83,260
Oromia,Gelan Town,Gelan Town,Miyazia,8,2010,56,49,75,180
Oromia,Nekemte Town,Nekemte Town,Teqemt,2,2010,24,65,4,93
Oromia,Guji,Wadara,Miyazia,8,2009,18,72,36,126
Oromia,West Hararge,Oda Bultum,Teqemt,2,2011,53,72,18,143
Oromia,North Shewa,Kuyu Hospital,Hamle,11,2009,37,90,26,153
Oromia,Jimma,Agaro,Yekatit,6,2010,5,70,76,151
Oromia,Nekemte Town,Nekemte Town,Miyazia,8,2011,35,67,70,172
Oromia,Qeleme Wellega,Hawa Gelan,Sene,10,2009,70,57,44,171
Oromia,South West Shewa,Tulu Bolo Hospital,Hamle,11,2009,20,95,6,121
Oromia,East Hararge,Kombolicha,Hamle,11,2010,89,34,59,182
Oromia,East Wellega,Ebantu,Yekatit,6,2009,54,6,33,93
Oromia,West Wellega,Nole Kaba,Ginbot,9,2010,38,93,46,177
Oromia,West Hararge,Burka Dimtu,Tir,5,2010,9,67,96,172
Oromia,East Wellega,Leqa Dulecha,Sene,10,2009,81,68,81,230
Oromia,West Shewa,Tibe Kutaye,Nehase,12,2009,23,24,45,92
Oromia,East Wellega,Leqa Dulecha,Hedar,3,2011,72,44,53,169
Oromia,Borena,Arero,Hedar,3,2010,63,47,78,188
Oromia,West Hararge,Tulo,Miyazia,8,2010,21,11,11,43
Oromia,East Hararge,Kersa Eh,Nehase,12,2010,95,12,53,160
Oromia,Bale,Gasera,Sene,10,2010,23,25,0,48
Oromia,Bale,Seweyna,Hedar,3,2010,74,4,37,115
Oromia,Jimma,B/Tolyi,Tir,5,2010,18,40,72,130
Oromia,Borena,Meyo,Megabit,7,2011,37,4,92,133
Oromia,West Wellega,Nole Kaba,Miyazia,8,2009,42,26,75,143
Oromia,Jimma,Tiro Afeta,Ginbot,9,2009,28,36,52,116
Oromia,Arsi,Deksis,Yekatit,6,2011,19,32,69,120
Oromia,East Hararge,Haromaya Rural,Tir,5,2010,63,45,11,119
Oromia,Guji,Wadara,Yekatit,6,2009,11,10,32,53
Oromia,North Shewa,Fichetown,Teqemt,2,2010,66,92,78,236
Oromia,Guji,Liben,Tir,5,2010,79,74,15,168
Oromia,Finfine Zuria,Walmera,Yekatit,6,2009,94,40,93,227
Oromia,North Shewa,Abichugna,Miyazia,8,2010,84,44,5,133
Oromia,Ilu Aba Bora,Bure,Ginbot,9,2009,90,70,28,188
Oromia,Buno Bedele,Dedesa,Tahesas,4,2011,71,88,85,244
Oromia,West Shewa,Chelia,Yekatit,6,2009,88,90,27,205
Oromia,Shashamane Town,Shashamane Town,Miyazia,8,2009,87,11,86,184
Oromia,Bale,Seweyna,Tahesas,4,2011,70,86,49,205
Oromia,West Wellega,Begi,Miyazia,8,2010,66,30,92,188
Oromia,Borena,Dilo,Teqemt,2,2010,85,1,23,109
Oromia,Arsi,Shirka,Tahesas,4,2010,9,68,98,175
Oromia,West Arsi,Arsi Negele Rural,Megabit,7,2010,4,29,99,132
Oromia,Finfine Zuria,Sandefa,Nehase,12,2009,24,22,10,56
Oromia,West Shewa,Dendi,Hamle,11,2010,69,18,52,139
Oromia,Horo Gudru Wellega,Hababo Guduru,Sene,10,2009,98,65,60,223
Oromia,West Shewa,Ginde Beret,Megabit,7,2010,66,71,19,156
Oromia,Jimma,O/Beyam,Ginbot,9,2009,88,66,2,156
Oromia,East Hararge,Bedeno,Tir,5,2009,34,77,65,176
Oromia,Arsi,Sude,Teqemt,2,2011,14,66,13,93
Oromia,Bale,Sinana,Tahesas,4,2010,12,33,42,87
Oromia,Buno Bedele,Diga,Hedar,3,2010,67,80,24,171
Oromia,West Wellega,Nejo Hospital,Tir,5,2011,56,27,50,133
Oromia,Arsi,Deksis,Sene,10,2009,95,32,86,213
Oromia,Guji,Saba Boru,Tir,5,2010,80,21,79,180
Oromia,Finfine Zuria,Sandefa,Miyazia,8,2009,49,52,19,120
Oromia,East Wellega,Limu,Ginbot,9,2009,78,10,58,146
Oromia,West Hararge,Oda Bultum,Ginbot,9,2010,79,58,78,215
Oromia,Guji,Adola Reda,Yekatit,6,2011,40,55,92,187
Oromia,East Wellega,Gudeyabila,Miyazia,8,2009,97,63,18,178
Oromia,Arsi,Tena,Tir,5,2010,72,93,62,227
Oromia,West Shewa,Ginde Beret,Miyazia,8,2011,83,3,87,173
Oromia,Ilu Aba Bora,Bilonopa,Yekatit,6,2011,80,39,20,139
Oromia,Ilu Aba Bora,Metu Town,Ginbot,9,2010,17,90,24,131
Oromia,Borena,Moyale,Ginbot,9,2011,73,45,46,164
Oromia,West Shewa,Tikur Enchini,Miyazia,8,2009,96,49,19,164
Oromia,West Shewa,Liban Jawi,Teqemt,2,2010,31,27,70,128
Oromia,Ilu Aba Bora,Ale,Ginbot,9,2009,1,53,30,84
Oromia,West Shewa,Ejersa Lafo,Yekatit,6,2010,11,94,37,142
Oromia,West Guji,Mkelka Soda,Hedar,3,2010,22,61,31,114
Oromia,Bale,Robe Town,Ginbot,9,2009,26,83,37,146
Oromia,Bale,Ginir,Sene,10,2010,10,75,67,152
Oromia,Ilu Aba Bora,Didu,Hedar,3,2010,50,54,22,126
Oromia,Bale,Agarfa,Nehase,12,2009,41,77,1,119
Oromia,West Hararge,Doba,Nehase,12,2010,6,48,23,77
Oromia,Arsi,Ludehetosa,Sene,10,2009,60,36,56,152
Oromia,Jimma,Guma,Hamle,11,2009,78,82,95,255
Oromia,West Shewa,Dendi,Megabit,7,2009,22,30,71,123
Oromia,Arsi,Enkelo Wabe,Meskerem,1,2010,45,78,0,123
Oromia,Horo Gudru Wellega,Amuru,Meskerem,1,2010,56,42,10,108
Oromia,East Hararge,Chelenko Hospital,Meskerem,1,2011,91,22,46,159
Oromia,West Guji,Bule Hora Toun,Miyazia,8,2011,79,92,22,193
Oromia,Arsi,Ludehetosa,Meskerem,1,2010,5,70,60,135
Oromia,Nekemte Town,Nekemte Town,Megabit,7,2010,45,98,5,148
Oromia,West Hararge,Daro Lebu,Tir,5,2009,52,20,43,115
Oromia,West Guji,Suro Barguda,Ginbot,9,2011,63,95,18,176
Oromia,Borena,Dubluk,Miyazia,8,2011,57,19,11,87
Oromia,South West Shewa,Dawo,Miyazia,8,2010,18,38,57,113
Oromia,North Shewa,Fiche Hospital,Ginbot,9,2009,17,73,77,167
Oromia,North Shewa,Degem,Nehase,12,2010,64,37,2,103
Oromia,Bale,Delo Mena,Tir,5,2010,16,40,53,109
Oromia,Finfine Zuria,Walmera,Meskerem,1,2011,60,52,12,124
Oromia,South West Shewa,Kersana Malima,Yekatit,6,2010,53,67,7,127
Oromia,West Hararge,Doba,Tir,5,2010,42,48,76,166
Oromia,West Wellega,Gimbi,Hamle,11,2009,9,1,31,41
Oromia,West Hararge,Chiro Zuriya,Miyazia,8,2009,55,94,68,217
Oromia,Arsi,Shirka,Tir,5,2009,83,91,53,227
Oromia,North Shewa,Yaya Gulele,Nehase,12,2010,87,93,30,210
Oromia,Shashamane Town,Shashamane Town,Miyazia,8,2010,46,79,84,209
Oromia,East Hararge,Haromaya Rural,Hamle,11,2010,7,60,66,133
Oromia,Arsi,Dodota,Tahesas,4,2011,52,95,2,149
Oromia,Horo Gudru Wellega,Horro Buluk,Megabit,7,2011,60,60,2,122
Oromia,East Shewa,Mojo,Miyazia,8,2009,48,51,38,137
Oromia,Horo Gudru Wellega,Jima Rare,Miyazia,8,2010,29,22,89,140
Oromia,Jimma,Tiro Afeta,Tir,5,2010,21,81,55,157
Oromia,West Wellega,Lalo Asabi,Hamle,11,2010,14,24,73,111
Oromia,Horo Gudru Wellega,Abe Dengoro,Hamle,11,2010,2,29,93,124
Oromia,West Wellega,Mendi Town,Sene,10,2011,70,59,20,149
Oromia,Qeleme Wellega,Laloqile,Tahesas,4,2010,99,78,97,274
Oromia,West Wellega,Nejo Town,Hedar,3,2010,56,21,61,138
Oromia,Ilu Aba Bora,Metu Rural,Hedar,3,2010,32,53,78,163
Oromia,West Hararge,Hawi Gudina,Sene,10,2009,81,88,43,212
Oromia,Finfine Zuria,Sebeta Awas,Hedar,3,2011,0,86,29,115
Oromia,Jimma,Guma,Meskerem,1,2011,48,74,1,123
Oromia,Guji,Negele Town,Ginbot,9,2010,16,12,21,49
Oromia,Ilu Aba Bora,Halu,Yekatit,6,2011,30,53,54,137
Oromia,West Hararge,Meiso,Tir,5,2011,66,9,58,133
Oromia,Jimma,Omonada,Tir,5,2009,27,78,48,153
Oromia,East Wellega,Haro Limu,Miyazia,8,2009,51,90,25,166
Oromia,Jimma,Sigmo,Meskerem,1,2010,67,55,1,123
Oromia,Bishoftu Town,Bishoftu Town,Tahesas,4,2011,34,60,62,156
Oromia,Guji,Gumi Eldallo,Meskerem,1,2010,27,0,99,126
Oromia,West Wellega,Jarso,Yekatit,6,2009,57,68,30,155
Oromia,West Shewa,Bako Hospital,Tir,5,2011,87,40,5,132
Oromia,Guji,Adola Reda,Tahesas,4,2011,78,62,91,231
Oromia,Shashamane Town,Shashamane Town,Megabit,7,2009,64,2,79,145
Oromia,West Shewa,Inchini Hospital,Tahesas,4,2010,35,94,94,223
Oromia,Jimma,Sigmo,Tir,5,2011,39,12,3,54
Oromia,West Hararge,Gemechis,Nehase,12,2010,3,65,8,76
Oromia,Borena,Arero,Tir,5,2010,67,32,41,140
Oromia,North Shewa,Girar Jarso,Miyazia,8,2009,71,88,81,240
Oromia,West Arsi,Siraro,Meskerem,1,2010,60,89,32,181
Oromia,Finfine Zuria,Walmera,Nehase,12,2009,44,84,5,133
Oromia,Horo Gudru Wellega,Jima Rare,Megabit,7,2009,87,34,71,192
Oromia,East Hararge,Deder Town,Tahesas,4,2010,8,70,40,118
Oromia,West Hararge,Mesela,Ginbot,9,2010,46,30,40,116
Oromia,Horo Gudru Wellega,Abay Chomen,Megabit,7,2010,13,97,15,125
Oromia,Arsi,Sire,Miyazia,8,2010,23,16,5,44
Oromia,Finfine Zuria,Holeta,Tir,5,2009,57,71,2,130
Oromia,Buno Bedele,Bedele Hospital,Meskerem,1,2010,1,86,84,171
Oromia,West Wellega,Begi Hospital,Hedar,3,2010,67,92,72,231
Oromia,Buno Bedele,Gechi,Sene,10,2009,32,41,66,139
Oromia,Ilu Aba Bora,Hurumu,Miyazia,8,2011,82,45,50,177
Oromia,Dukem Town,Dukem Town,Sene,10,2009,97,28,94,219
Oromia,Jimma,Dedo,Ginbot,9,2010,18,74,59,151
Oromia,Ilu Aba Bora,Bilonopa,Ginbot,9,2010,96,97,35,228
Oromia,South West Shewa,Tulu Bolo Hospital,Megabit,7,2010,86,48,33,167
Oromia,East Hararge,Haromaya Rural,Hedar,3,2011,94,25,72,191
Oromia,South West Shewa,Tulu Bolo Hospital,Teqemt,2,2011,47,78,3,128
Oromia,North Shewa,Dera Hospital,Miyazia,8,2009,18,38,4,60
Oromia,West Arsi,Kofele,Megabit,7,2010,75,70,56,201
Oromia,East Hararge,Meyu Muleke,Tahesas,4,2010,36,96,20,152
Oromia,Buno Bedele,Bedele Zuriya,Teqemt,2,2010,86,92,66,244
Oromia,West Arsi,Shala,Meskerem,1,2011,76,73,74,223
Oromia,Gelan Town,Gelan Town,Tahesas,4,2011,17,6,5,28
Oromia,Borena,Moyale,Megabit,7,2009,87,53,63,203
Oromia,Arsi,Shenan Kolu,Yekatit,6,2010,29,34,85,148
Oromia,North Shewa,Hidabu Abote,Nehase,12,2010,82,42,1,125
Oromia,West Shewa,Meta Waliqite,Tir,5,2010,75,26,86,187
Oromia,West Guji,Mkelka Soda,Sene,10,2011,70,70,40,180
Oromia,East Shewa,Fentale,Miyazia,8,2011,89,48,8,145
Oromia,North Shewa,Kuyu,Hedar,3,2010,80,51,51,182
Oromia,West Wellega,Begi,Miyazia,8,2009,26,41,11,78
Oromia,Buno Bedele,Bedele Town,Hamle,11,2010,41,57,64,162
Oromia,West Shewa,Ilu Galan,Yekatit,6,2010,16,83,50,149
Oromia,Buno Bedele,Dedesa,Tir,5,2009,68,41,32,141
Oromia,West Arsi,Wondo,Miyazia,8,2009,58,7,36,101
Oromia,West Hararge,Anchar,Tahesas,4,2011,78,83,58,219
Oromia,East Wellega,Ebantu,Sene,10,2011,30,49,53,132
Oromia,Buno Bedele,Bedele Zuriya,Megabit,7,2009,64,29,54,147
Oromia,West Arsi,Kore,Nehase,12,2010,43,52,19,114
Oromia,Borena,Wachile,Meskerem,1,2011,10,93,88,191
Oromia,North Shewa,Dera,Tir,5,2010,33,96,25,154
Oromia,Arsi,Amigna,Meskerem,1,2010,28,99,27,154
Oromia,Guji,Anna Sora,Megabit,7,2010,23,86,70,179
Oromia,Arsi,Seru,Hamle,11,2009,21,7,0,28
Oromia,North Shewa,Debre Libanos,Meskerem,1,2010,14,30,39,83
Oromia,East Hararge,Kumbi,Megabit,7,2010,35,64,86,185
Oromia,West Arsi,Wondo,Ginbot,9,2010,77,84,94,255
Oromia,Qeleme Wellega,Laloqile,Ginbot,9,2011,8,31,59,98
Oromia,Gelan Town,Gelan Town,Nehase,12,2010,27,84,2,113
Oromia,Qeleme Wellega,Seyo,Teqemt,2,2010,0,0,84,84
Oromia,Guji,Gumi Eldallo,Megabit,7,2009,68,67,54,189
Oromia,Horo Gudru Wellega,Shambu Hospital,Sene,10,2009,11,11,67,89
Oromia,West Wellega,Jarso,Tir,5,2011,1,92,82,175
Oromia,Guji,Uraga,Tir,5,2010,70,12,20,102
Oromia,West Wellega,Haru,Ginbot,9,2009,93,1,98,192
Oromia,Borena,Dire,Tahesas,4,2011,4,28,5,37
Oromia,West Shewa,Gedo Hospital,Ginbot,9,2011,76,23,12,111
Oromia,Arsi,Merti,Yekatit,6,2010,65,12,14,91
Oromia,East Hararge,Haromaya Hospital,Megabit,7,2009,25,54,95,174
Oromia,Jimma,Limu Seka,Tir,5,2009,36,68,51,155
Oromia,East Hararge,Goro Gutu,Megabit,7,2011,63,65,49,177
Oromia,West Shewa,Tikur Enchini,Nehase,12,2010,17,31,33,81
Oromia,West Shewa,Abuna Gindeberet,Tir,5,2011,40,94,19,153
Oromia,West Guji,Bule Hora Toun,Nehase,12,2010,41,94,46,181
Oromia,East Hararge,Gursum,Tir,5,2009,66,88,36,190
Oromia,Guji,Saba Boru,Yekatit,6,2009,30,72,36,138
Oromia,Qeleme Wellega,Yemalogi Wolel,Tahesas,4,2011,54,6,19,79
Oromia,West Hararge,Mesela,Sene,10,2010,39,99,86,224
Oromia,East Shewa,Adea,Ginbot,9,2009,47,23,0,70
Oromia,West Wellega,Boji Dermeji,Nehase,12,2010,62,2,84,148
Oromia,West Guji,Bule Hora Toun,Teqemt,2,2010,70,75,72,217
Oromia,Arsi,Munesa,Miyazia,8,2009,78,6,7,91
Oromia,South West Shewa,Wonchi,Yekatit,6,2011,48,79,87,214
Oromia,Jimma,Tiro Afeta,Nehase,12,2010,82,8,86,176
Oromia,West Arsi,Siraro,Sene,10,2011,11,67,89,167
Oromia,Qeleme Wellega,Dale Sedi,Hedar,3,2011,95,45,42,182
Oromia,Jimma,Limu Seka,Meskerem,1,2010,14,3,52,69
Oromia,East Hararge,Midega Tole,Tahesas,4,2011,62,43,73,178
Oromia,West Hararge,Chiro Zuriya,Tahesas,4,2010,75,56,49,180
Oromia,Sebeta Town,Sebeta Town,Hedar,3,2011,65,14,70,149
Oromia,West Guji,Suro Barguda,Tahesas,4,2010,59,99,61,219
Oromia,South West Shewa,St.Luke Hospital,Megabit,7,2010,54,75,85,214
Oromia,West Hararge,Oda Bultum,Hedar,3,2010,78,72,69,219
Oromia,East Shewa,Adami Tulu Jido Kombolcha,Yekatit,6,2010,92,13,20,125
Oromia,East Hararge,Midega Tole,Miyazia,8,2010,9,46,44,99
Oromia,East Hararge,Kombolicha,Ginbot,9,2011,69,90,66,225
Oromia,Jimma,Nono Benja,Ginbot,9,2011,29,67,96,192
Oromia,West Arsi,Kokosa,Tir,5,2009,68,27,32,127
Oromia,West Wellega,Genji,Megabit,7,2011,2,59,38,99
Oromia,West Hararge,Hawi Gudina,Megabit,7,2011,9,27,30,66
Oromia,West Shewa,Chelia,Sene,10,2011,82,55,20,157
Oromia,West Wellega,Yubdo,Ginbot,9,2011,90,70,10,170
Oromia,Bale,Dawe Qachen,Nehase,12,2010,19,31,1,51
Oromia,East Wellega,Haro Limu,Tir,5,2009,85,10,47,142
Oromia,Nekemte Town,Nekemte Town,Nehase,12,2010,30,88,20,138
Oromia,Ilu Aba Bora,Doreni,Miyazia,8,2010,71,54,81,206
Oromia,North Shewa,Girar Jarso,Hamle,11,2009,4,39,43,86
Oromia,Jimma,Gomma,Miyazia,8,2009,59,70,24,153
Oromia,Bale,Delo Mena,Miyazia,8,2009,41,70,45,156
Oromia,Bale,Meda Welabu,Tir,5,2011,56,55,94,205
Oromia,Arsi,Ludehetosa,Sene,10,2009,20,14,52,86
Oromia,Bale,Goba,Yekatit,6,2011,67,80,78,225
Oromia,East Hararge,Jarso,Nehase,12,2009,90,73,9,172
Oromia,Buno Bedele,Chewaqa,Ginbot,9,2011,70,80,85,235
Oromia,East Hararge,Girawa,Yekatit,6,2011,18,48,18,84
Oromia,West Wellega,Seyo Nole,Megabit,7,2009,18,92,26,136
Oromia,Finfine Zuria,Sebeta Awas,Megabit,7,2010,77,37,70,184
Oromia,West Shewa,Tikur Enchini,Ginbot,9,2009,26,65,46,137
Oromia,Jimma,Mana,Megabit,7,2009,19,20,70,109
Oromia,Horo Gudru Wellega,Abe Dengoro,Tahesas,4,2010,56,98,60,214
Oromia,West Shewa,Elifata,Meskerem,1,2010,4,64,3,71
Oromia,West Arsi,Hebal Arsi,Yekatit,6,2010,14,13,97,124
Oromia,West Arsi,Nensebo,Sene,10,2009,95,22,10,127
Oromia,Guji,Anna Sora,Yekatit,6,2010,99,60,23,182
Oromia,Jimma,Limu Kosa,Megabit,7,2010,17,85,20,122
Oromia,West Wellega,Begi,Megabit,7,2011,97,66,96,259
Oromia,West Wellega,Gimbi Rural,Hedar,3,2010,99,49,46,194
Oromia,West Hararge,Gelemso Hospital,Megabit,7,2010,81,34,23,138
Oromia,Qeleme Wellega,Kake Hosp,Ginbot,9,2011,42,9,33,84
Oromia,Guji,Liben,Sene,10,2009,69,73,14,156
Oromia,East Hararge,Goro Gutu,Tahesas,4,2010,18,64,75,157
Oromia,Qeleme Wellega,Gidami,Nehase,12,2009,4,39,81,124
Oromia,Guji,Saba Boru,Teqemt,2,2011,75,20,76,171
Oromia,Horo Gudru Wellega,Abay Chomen,Miyazia,8,2010,78,0,94,172
Oromia,West Guji,Bule Hora Toun,Yekatit,6,2009,55,91,74,220
Oromia,Jimma,Seka Chekorsa,Hedar,3,2011,92,83,97,272
Oromia,Borena,Dilo,Yekatit,6,2010,71,71,49,191
Oromia,West Wellega,Seyo Nole,Nehase,12,2010,22,79,92,193
Oromia,West Arsi,Nensebo,Miyazia,8,2011,55,96,54,205
Oromia,Qeleme Wellega,Seyo,Tir,5,2010,57,54,8,119
Oromia,Horo Gudru Wellega,Horro Buluk,Tahesas,4,2010,23,99,81,203
Oromia,Buno Bedele,Bedele Town,Meskerem,1,2011,7,76,93,176
Oromia,Ilu Aba Bora,Nono Sele,Nehase,12,2009,61,3,74,138
Oromia,Arsi,Chole,Sene,10,2009,95,38,65,198
Oromia,East Shewa,Adama,Meskerem,1,2011,91,61,28,180
Oromia,West Wellega,Seyo Nole,Teqemt,2,2011,71,91,26,188
Oromia,North Shewa,Kuyu,Miyazia,8,2011,4,9,35,48
Oromia,Bale,Goba,Yekatit,6,2009,8,50,87,145
Oromia,South West Shewa,Woliso Rural,Ginbot,9,2010,42,44,9,95
Oromia,Horo Gudru Wellega,Shambu Town,Yekatit,6,2011,78,4,82,164
Oromia,West Shewa,Jeldu,Tir,5,2009,3,60,50,113
Oromia,Bale,Dawe Serar,Ginbot,9,2011,73,19,39,131
Oromia,West Arsi,Gedeb Asasa,Miyazia,8,2009,77,82,34,193
Oromia,East Wellega,Sasiga,Ginbot,9,2009,68,19,59,146
Oromia,West Wellega,Boji Cheqorsa,Hamle,11,2010,91,12,2,105
Oromia,Bale,Goba Town,Tir,5,2011,33,56,72,161
Oromia,West Hararge,Doba,Hamle,11,2009,75,38,33,146
Oromia,East Shewa,Gimbichu,Miyazia,8,2010,93,25,60,178
Oromia,East Wellega,Boneya Bushe,Sene,10,2011,22,26,62,110
Oromia,Arsi,Tena,Ginbot,9,2010,48,74,30,152
Oromia,West Wellega,Mene Sibu,Ginbot,9,2011,95,7,26,128
Oromia,West Shewa,Tibe Kutaye,Ginbot,9,2011,24,7,63,94
Oromia,West Arsi,Arsi Negele Town,Hamle,11,2009,28,53,18,99
Oromia,Arsi,Amigna,Tir,5,2009,83,80,94,257
Oromia,East Hararge,Bisidimo Hospital,Sene,10,2009,96,79,56,231
Oromia,South West Shewa,Kersana Malima,Hamle,11,2009,82,11,65,158
Oromia,North Shewa,Wuchale,Nehase,12,2009,1,5,6,12
Oromia,West Guji,Abaya,Meskerem,1,2010,34,43,74,151
Oromia,Horo Gudru Wellega,Gudru,Ginbot,9,2011,72,33,90,195
Oromia,Bishoftu Town,Bishoftu Town,Megabit,7,2011,55,95,41,191
Oromia,West Hararge,Meiso,Hedar,3,2010,52,21,48,121
Oromia,East Hararge,Kumbi,Megabit,7,2009,79,39,45,163
Oromia,East Hararge,Kumbi,Nehase,12,2009,59,98,79,236
Oromia,West Shewa,Ginde Beret,Meskerem,1,2010,20,30,18,68
Oromia,West Guji,Suro Barguda,Ginbot,9,2010,50,57,59,166
Oromia,Borena,Dubluk,Hamle,11,2009,82,24,11,117
Oromia,Arsi,Deksis,Tir,5,2011,9,7,13,29
Oromia,West Arsi,Shala,Ginbot,9,2010,79,39,99,217
Oromia,South West Shewa,Dawo,Miyazia,8,2010,5,72,34,111
Oromia,West Shewa,Jibat,Yekatit,6,2009,9,0,14,23
Oromia,East Hararge,Gole Oda,Megabit,7,2009,61,12,57,130
Oromia,East Shewa,Adami Tulu Jido Kombolcha,Nehase,12,2010,11,25,51,87
Oromia,West Guji,Bule Hora Toun,Sene,10,2010,26,8,81,115
Oromia,West Arsi,Dodola  Hospital,Tir,5,2011,17,92,74,183
Oromia,East Hararge,Fedis,Ginbot,9,2010,74,81,66,221
Oromia,West Wellega,Nejo Hospital,Megabit,7,2010,91,93,20,204
Oromia,East Shewa,Boset,Tir,5,2010,33,33,84,150
Oromia,West Shewa,Nono,Tahesas,4,2011,27,47,83,157
Oromia,Guji,Liben,Hedar,3,2010,23,31,36,90
Oromia,East Hararge,Midega Tole,Meskerem,1,2010,66,26,63,155
Oromia,West Arsi,Dodola Town,Megabit,7,2009,53,99,65,217
Oromia,West Hararge,West Harerge	Gumbi Bordede,Ginbot,9,2011,18,81,60,159
Oromia,East Hararge,Melka Belo,Hedar,3,2011,84,88,88,260
Oromia,Qeleme Wellega,Dale Wabera,Tir,5,2011,72,49,54,175
Oromia,Bale,Raitu,Sene,10,2010,61,50,36,147
Oromia,East Shewa,Batu,Hamle,11,2010,47,32,61,140
Oromia,East Wellega,Gobu Seyo,Nehase,12,2009,44,40,83,167
Oromia,Dukem Town,Dukem Town,Yekatit,6,2010,54,58,65,177
Oromia,Bale,Berbere,Sene,10,2009,4,86,93,183
Oromia,Ilu Aba Bora,Metu Rural,Ginbot,9,2011,99,64,25,188
Oromia,West Wellega,Kundala,Nehase,12,2009,58,62,62,182
Oromia,West Guji,Bule Hora Hospital,Ginbot,9,2009,18,49,30,97
Oromia,Ilu Aba Bora,Metu Rural,Sene,10,2011,32,76,90,198
Oromia,East Wellega,Guto Gida,Sene,10,2011,83,99,1,183
Oromia,North Shewa,Kimbibit,Nehase,12,2009,27,38,21,86
Oromia,Qeleme Wellega,Dale Sedi,Sene,10,2011,62,9,90,161
Oromia,East Shewa,Fentale,Yekatit,6,2010,75,92,69,236
Oromia,Guji,Goro Dola,Tir,5,2010,25,35,61,121
Oromia,East Hararge,Girawa,Nehase,12,2009,24,27,35,86
Oromia,Ilu Aba Bora,Halu,Yekatit,6,2010,33,29,54,116
Oromia,West Shewa,Dano,Ginbot,9,2009,99,5,53,157
Oromia,Arsi,Limuna Bilbilo,Megabit,7,2010,84,86,37,207
Oromia,West Wellega,Begi Hospital,Tir,5,2009,52,20,86,158
Oromia,East Hararge,Meta,Sene,10,2009,75,54,54,183
Oromia,Buno Bedele,Chewaqa,Ginbot,9,2009,35,17,83,135
Oromia,Horo Gudru Wellega,Abay Chomen,Ginbot,9,2011,11,23,79,113
Oromia,Bale,Gura Dhamole,Hamle,11,2009,72,23,25,120
Oromia,Arsi,Tiyo,Tir,5,2009,48,40,37,125
Oromia,West Arsi,Arsi Negele Town,Ginbot,9,2010,31,98,49,178
Oromia,West Arsi,Shashemene Rural,Sene,10,2009,30,13,82,125
Oromia,Jimma,Shabe,Ginbot,9,2011,73,12,7,92
Oromia,North Shewa,Kuyu Hospital,Yekatit,6,2011,22,10,70,102
Oromia,West Shewa,Guder Hosp,Hedar,3,2011,35,68,83,186
Oromia,West Wellega,Yubdo,Ginbot,9,2010,40,93,90,223
Oromia,Horo Gudru Wellega,Hababo Guduru,Nehase,12,2009,27,49,1,77
Oromia,East Wellega,Haro Limu,Meskerem,1,2010,99,48,71,218
Oromia,Ilu Aba Bora,Becho,Hedar,3,2010,30,64,90,184
Oromia,Buno Bedele,Meko,Yekatit,6,2011,77,0,25,102
Oromia,Shashamane Town,Shashamane Town,Yekatit,6,2009,51,36,97,184
Oromia,East Hararge,Kumbi,Ginbot,9,2009,39,31,62,132
Oromia,East Hararge,Deder Hospital,Megabit,7,2009,29,16,41,86
Oromia,Qeleme Wellega,Anfilo,Meskerem,1,2010,93,25,23,141
Oromia,East Hararge,Chinakesen,Ginbot,9,2009,36,12,90,138
Oromia,East Wellega,Diga,Hedar,3,2010,7,25,33,65
Oromia,Ilu Aba Bora,Bure,Meskerem,1,2010,13,65,71,149
Oromia,West Shewa,Ambo Hospital,Miyazia,8,2010,76,53,2,131
Oromia,West Wellega,Genji,Nehase,12,2009,27,77,31,135
Oromia,Modjo Town,Modjo Town,Tir,5,2011,28,37,72,137
Oromia,Arsi,Robe,Megabit,7,2011,49,86,55,190
Oromia,West Shewa,Meta Waliqite,Meskerem,1,2010,16,1,0,17
Oromia,Horo Gudru Wellega,Shambu Town,Tahesas,4,2011,75,24,98,197
Oromia,Bale,Goba Town,Teqemt,2,2011,61,99,11,171
Oromia,West Shewa,Ejersa Lafo,Hedar,3,2010,7,31,79,117
Oromia,South West Shewa,Becho,Hamle,11,2010,49,5,88,142
Oromia,Guji,Hambela Wamena,Hedar,3,2011,78,59,90,227
Oromia,Horo Gudru Wellega,Horo,Miyazia,8,2010,20,95,10,125
Oromia,West Hararge,Burka Dimtu,Megabit,7,2010,16,28,63,107
Oromia,Borena,Wachile,Miyazia,8,2009,91,41,20,152
Oromia,South West Shewa,Tole,Tir,5,2011,39,0,2,41
Oromia,Arsi,Tena,Miyazia,8,2010,57,31,97,185
Oromia,East Hararge,Haromaya Rural,Nehase,12,2009,40,9,99,148
Oromia,West Shewa,Ejersa Lafo,Hedar,3,2011,92,3,47,142
Oromia,Arsi,Ludehetosa,Tir,5,2011,6,34,28,68
Oromia,South West Shewa,Ilu,Teqemt,2,2010,22,58,89,169
Oromia,West Shewa,Tibe Kutaye,Megabit,7,2010,80,89,12,181
Oromia,West Guji,Gelana,Hamle,11,2009,8,6,21,35
Oromia,West Wellega,Begi,Teqemt,2,2010,74,8,67,149
Oromia,West Hararge,Chiro Hospital,Sene,10,2009,5,47,40,92
Oromia,West Wellega,Lalo Asabi,Nehase,12,2010,94,31,88,213
Oromia,Ilu Aba Bora,Algesachi,Ginbot,9,2010,68,61,19,148
Oromia,Guji,Bore,Sene,10,2009,94,91,35,220
Oromia,Horo Gudru Wellega,Jarte Jardga,Nehase,12,2010,18,14,89,121
Oromia,West Wellega,Guliso,Hamle,11,2010,42,90,73,205
Oromia,West Hararge,Daro Lebu,Teqemt,2,2010,80,87,72,239
Oromia,East Hararge,Meyu Muleke,Yekatit,6,2010,42,53,1,96
Oromia,West Hararge,Chiro Zuriya,Megabit,7,2010,10,28,14,52
Oromia,Buno Bedele,Chewaqa,Ginbot,9,2011,33,15,66,114
Oromia,East Hararge,Haromaya Rural,Tir,5,2010,39,3,23,65
Oromia,West Hararge,Mesela,Yekatit,6,2009,67,5,95,167
Oromia,Ilu Aba Bora,Bilonopa,Hamle,11,2009,95,44,23,162
Oromia,Buno Bedele,Meko,Tahesas,4,2011,35,78,11,124
Oromia,Bale,Agarfa,Yekatit,6,2009,80,22,96,198
Oromia,Borena,Dire,Teqemt,2,2010,0,81,82,163
Oromia,Arsi,Zeway Dugda,Ginbot,9,2010,44,88,94,226
Oromia,West Shewa,Dendi,Miyazia,8,2009,47,4,32,83
Oromia,East Hararge,Deder,Tir,5,2009,49,71,80,200
Oromia,Jimma,Limu Seka,Tir,5,2010,47,57,22,126
Oromia,West Shewa,Abuna Gindeberet,Sene,10,2009,74,53,85,212
Oromia,Arsi,Amigna,Sene,10,2009,47,7,87,141
Oromia,Holeta Town,Holeta Town,Tahesas,4,2010,17,11,66,94
Oromia,Bale,Raitu,Miyazia,8,2009,1,29,68,98
Oromia,East Hararge,Aweday Town,Ginbot,9,2011,62,57,67,186
Oromia,Buno Bedele,Meko,Sene,10,2009,54,41,74,169
Oromia,East Shewa,Lomme,Yekatit,6,2009,44,98,7,149
Oromia,West Shewa,Codi,Teqemt,2,2011,42,19,16,77
Oromia,Arsi,Deksis,Hedar,3,2011,19,65,13,97
Oromia,West Hararge,Chiro Town,Tahesas,4,2010,61,3,80,144
Oromia,Jimma,Agaro,Meskerem,1,2011,99,31,19,149
Oromia,East Hararge,Jarso,Megabit,7,2010,8,29,39,76
Oromia,Ilu Aba Bora,Darimu,Hamle,11,2010,12,45,57,114
Oromia,West Hararge,Chiro Hospital,Meskerem,1,2011,58,18,88,164
Oromia,West Wellega,Jarso,Ginbot,9,2011,53,15,51,119
Oromia,West Shewa,Metarobi,Nehase,12,2009,66,99,63,228
Oromia,West Shewa,Jibat,Megabit,7,2010,28,53,62,143
Oromia,Guji,Adola Town,Tahesas,4,2010,41,60,95,196
Oromia,Bale,Legehida,Miyazia,8,2011,71,60,10,141
Oromia,North Shewa,Wuchale,Nehase,12,2010,27,6,42,75
Oromia,West Arsi,Kore,Teqemt,2,2010,16,86,45,147
Oromia,West Hararge,Bedesa Town,Sene,10,2010,71,98,6,175
Oromia,West Arsi,Dodola Town,Nehase,12,2009,69,68,82,219
Oromia,West Arsi,Dodola Town,Tir,5,2011,70,38,93,201
Oromia,Borena,Dire,Megabit,7,2009,86,43,43,172
Oromia,Guji,Aga Wayyu,Tahesas,4,2011,21,32,45,98
Oromia,Modjo Town,Modjo Town,Teqemt,2,2010,31,26,1,58
Oromia,Borena,Moyale,Megabit,7,2010,70,82,30,182
Oromia,West Wellega,Boji Dermeji,Hedar,3,2011,50,61,96,207
Oromia,Horo Gudru Wellega,Horro Buluk,Nehase,12,2010,10,21,74,105
Oromia,Qeleme Wellega,Sedan Chanka,Tir,5,2010,34,60,90,184
Oromia,West Wellega,Begi,Meskerem,1,2011,22,31,26,79
Oromia,Guji,Uraga,Yekatit,6,2010,43,46,98,187
Oromia,East Hararge,Deder Hospital,Sene,10,2011,73,60,34,167
Oromia,West Shewa,Gojo Hospital,Teqemt,2,2011,63,10,82,155
Oromia,Nekemte Town,Nekemte Town,Tahesas,4,2010,77,18,22,117
Oromia,Qeleme Wellega,Laloqile,Hamle,11,2010,20,75,84,179
Oromia,East Hararge,Babile,Sene,10,2011,50,4,68,122
Oromia,East Hararge,Goro Muti,Teqemt,2,2011,66,78,62,206
Oromia,Bale,Gura Dhamole,Nehase,12,2010,94,43,99,236
Oromia,Horo Gudru Wellega,Amuru,Hamle,11,2009,24,96,48,168
Oromia,Horo Gudru Wellega,Amuru,Megabit,7,2011,19,9,82,110
Oromia,West Guji,Kercha,Tahesas,4,2010,55,57,96,208
Oromia,Guji,Anna Sora,Yekatit,6,2009,35,55,6,96
Oromia,Guji,Dima,Sene,10,2009,41,99,58,198
Oromia,Borena,Dhas,Hedar,3,2010,15,45,10,70
Oromia,West Arsi,Adaba,Hamle,11,2010,22,88,4,114
Oromia,West Hararge,Oda Bultum,Sene,10,2011,79,74,82,235
Oromia,East Wellega,Limu,Hamle,11,2010,19,89,91,199
Oromia,East Wellega,Boneya Bushe,Nehase,12,2010,10,38,27,75
Oromia,Ilu Aba Bora,Darimu,Teqemt,2,2010,66,34,4,104
Oromia,Guji,Saba Boru,Tir,5,2011,24,22,45,91
Oromia,Horo Gudru Wellega,Hababo Guduru,Hamle,11,2009,45,33,66,144
Oromia,East Wellega,Haro Limu,Meskerem,1,2010,82,50,79,211
Oromia,Arsi,Sire,Yekatit,6,2011,4,1,60,65
Oromia,West Arsi,Loke Hada Hospital,Tir,5,2011,6,25,59,90
Oromia,West Arsi,Arsi Negele Town,Megabit,7,2010,19,90,28,137
Oromia,South West Shewa,Sodo Dac'Ha,Tahesas,4,2010,48,43,48,139
Oromia,East Hararge,Fedis,Tir,5,2011,76,66,86,228
Oromia,Bale,Delo Mena,Ginbot,9,2010,3,39,70,112
Oromia,East Hararge,Deder Hospital,Sene,10,2010,67,92,77,236
Oromia,Bishoftu Town,Bishoftu Town,Teqemt,2,2010,54,6,71,131
Oromia,West Shewa,Ejerie,Miyazia,8,2010,37,62,27,126
Oromia,East Hararge,Midega Tole,Megabit,7,2009,55,60,10,125
Oromia,West Hararge,Gelemso Hospital,Hedar,3,2010,3,65,71,139
Oromia,East Hararge,Gursum,Megabit,7,2010,62,29,92,183
Oromia,Jimma,B/Tolyi,Nehase,12,2010,11,17,95,123
Oromia,Borena,Moyale,Miyazia,8,2009,56,36,29,121
Oromia,East Wellega,Wayu Tuqa,Miyazia,8,2009,86,25,69,180
Oromia,East Wellega,Limu,Yekatit,6,2010,6,73,85,164
Oromia,Jimma,Shabe,Nehase,12,2010,9,99,81,189
Oromia,West Shewa,Tikur Enchini,Tir,5,2010,80,29,9,118
Oromia,West Wellega,Ayira Hospital,Sene,10,2010,29,46,10,85
Oromia,South West Shewa,Tole,Sene,10,2010,27,24,48,99
Oromia,Buno Bedele,Dedesa,Ginbot,9,2010,49,90,79,218
Oromia,West Wellega,Mendi Hospital,Miyazia,8,2010,99,10,19,128
Oromia,West Guji,Biebirsa Kojowa,Tahesas,4,2010,58,67,4,129
Oromia,West Shewa,Ambo,Sene,10,2011,75,81,27,183
Oromia,Shashamane Town,Shashamane Town,Hedar,3,2010,54,11,25,90
Oromia,North Shewa,Hidabu Abote,Tir,5,2010,93,47,39,179
Oromia,Assela Town,Assela Town,Sene,10,2009,89,50,48,187
Oromia,West Wellega,Nejo Hospital,Nehase,12,2009,28,90,9,127
Oromia,East Hararge,Bedeno,Ginbot,9,2011,83,67,57,207
Oromia,East Wellega,Wayu Tuqa,Teqemt,2,2011,35,3,46,84
Oromia,Horo Gudru Wellega,Gudru,Hedar,3,2011,10,7,74,91
Oromia,Arsi,Sire,Sene,10,2009,92,20,29,141
Oromia,Burayu Town,Burayu Town,Sene,10,2009,68,59,2,129
Oromia,West Wellega,Homa,Meskerem,1,2011,69,54,29,152
Oromia,West Wellega,Yubdo,Yekatit,6,2009,90,25,63,178
Oromia,Horo Gudru Wellega,Horo,Megabit,7,2010,1,16,37,54
Oromia,North Shewa,Jido,Tahesas,4,2010,47,55,7,109
Oromia,West Shewa,Ilu Galan,Tir,5,2010,18,44,7,69
Oromia,Jimma,Omonada,Ginbot,9,2010,42,13,54,109
Oromia,West Hararge,Gelemso Hospital,Hamle,11,2010,55,97,0,152
Oromia,West Wellega,Babo Gembel,Nehase,12,2009,67,78,11,156
Oromia,West Wellega,Yubdo,Tir,5,2010,62,49,27,138
Oromia,Horo Gudru Wellega,Gudru,Sene,10,2011,73,96,31,200
Oromia,Qeleme Wellega,Laloqile,Tahesas,4,2011,20,24,36,80
Oromia,East Hararge,Haromaya Town,Miyazia,8,2011,8,20,51,79
Oromia,Burayu Town,Burayu Town,Tir,5,2010,33,67,98,198
Oromia,Bale,Goba Town,Hamle,11,2009,43,95,41,179
Oromia,West Hararge,Hawi Gudina,Ginbot,9,2010,18,46,19,83
Oromia,Adama Special Town,Adama Town,Miyazia,8,2009,8,76,8,92
Oromia,Nekemte Town,Nekemte Town,Sene,10,2011,10,36,21,67
Oromia,West Hararge,Chiro Hospital,Hedar,3,2010,17,77,82,176
Oromia,West Shewa,Tibe Kutaye,Meskerem,1,2010,7,25,34,66
Oromia,Bale,Dawe Qachen,Yekatit,6,2011,54,15,97,166
Oromia,West Wellega,Haru,Miyazia,8,2010,27,3,42,72
Oromia,Qeleme Wellega,Dale Wabera,Yekatit,6,2010,17,42,22,81
Oromia,Arsi,Gololcha,Nehase,12,2010,47,91,88,226
Oromia,Ilu Aba Bora,Doreni,Ginbot,9,2011,86,76,64,226
Oromia,Jimma,Seka Chhokorsa Hospital,Megabit,7,2011,80,92,66,238
Oromia,Finfine Zuria,Sebeta Awas,Meskerem,1,2011,53,23,60,136
Oromia,West Guji,Biebirsa Kojowa,Miyazia,8,2011,28,28,86,142
Oromia,Arsi,Tiyo,Ginbot,9,2009,75,26,27,128
Oromia,South West Shewa,Ilu,Yekatit,6,2009,55,64,80,199
Oromia,South West Shewa,St.Luke Hospital,Hamle,11,2009,66,27,37,130
Oromia,West Guji,Abaya,Nehase,12,2010,94,61,12,167
Oromia,Buno Bedele,Gechi,Miyazia,8,2010,9,38,94,141
Oromia,Buno Bedele,Bedele Town,Teqemt,2,2010,26,87,8,121
Oromia,East Hararge,Gursum,Ginbot,9,2011,77,35,81,193
Oromia,Borena,Dire,Yekatit,6,2009,55,11,57,123
Oromia,Horo Gudru Wellega,Horo,Sene,10,2010,7,34,84,125
Oromia,East Hararge,Meyu Muleke,Megabit,7,2011,2,37,88,127
Oromia,West Shewa,Metarobi,Ginbot,9,2009,27,33,90,150
Oromia,Qeleme Wellega,Yemalogi Wolel,Ginbot,9,2010,86,82,75,243
Oromia,East Hararge,Gursum,Tir,5,2010,51,90,61,202
Oromia,Arsi,Bekoji Town,Tahesas,4,2010,71,0,93,164
Oromia,Guji,Uraga,Nehase,12,2009,15,55,3,73
Oromia,East Shewa,Adama,Ginbot,9,2011,94,28,55,177
Oromia,West Hararge,Oda Bultum,Tir,5,2011,99,95,85,279
Oromia,Arsi,Bale Gesgara,Sene,10,2011,75,45,42,162
Oromia,West Guji,Kercha,Hamle,11,2010,25,76,31,132
Oromia,Bale,Ginir Town,Miyazia,8,2011,68,66,79,213
Oromia,East Shewa,Fentale,Tir,5,2011,14,31,26,71
Oromia,Bale,Arena Buluq,Yekatit,6,2010,13,80,91,184
Oromia,West Hararge,Chiro Zuriya,Miyazia,8,2010,16,94,79,189
Oromia,Dukem Town,Dukem Town,Teqemt,2,2010,97,46,82,225
Oromia,West Hararge,Meiso,Sene,10,2010,49,69,40,158
Oromia,West Wellega,Yubdo,Megabit,7,2009,29,9,56,94
Oromia,Jimma,O/Beyam,Sene,10,2009,83,50,31,164
Oromia,East Wellega,Diga,Ginbot,9,2011,93,56,64,213
Oromia,South West Shewa,Ameya Hospital,Ginbot,9,2011,21,84,64,169
Oromia,Borena,Yabelo Rural,Tahesas,4,2010,49,24,68,141
Oromia,East Hararge,Kombolicha,Tahesas,4,2010,4,95,33,132
Oromia,Horo Gudru Wellega,Abay Chomen,Megabit,7,2010,77,68,24,169
Oromia,South West Shewa,Tulu Bolo Hospital,Hamle,11,2010,87,54,34,175
Oromia,East Hararge,Meyu Muleke,Ginbot,9,2009,91,41,89,221
Oromia,North Shewa,Abichugna,Miyazia,8,2010,22,56,11,89
Oromia,West Shewa,Elifata,Nehase,12,2010,1,53,17,71
Oromia,Guji,Liben,Tir,5,2010,78,99,40,217
Oromia,South West Shewa,Ameya,Tahesas,4,2010,43,32,95,170
Oromia,East Wellega,Kiremu,Tir,5,2009,65,50,6,121
Oromia,West Hararge,Hawi Gudina,Teqemt,2,2010,37,41,26,104
Oromia,Horo Gudru Wellega,Abe Dengoro,Hedar,3,2010,70,87,23,180
Oromia,North Shewa,Yaya Gulele,Ginbot,9,2010,23,86,26,135
Oromia,West Wellega,Gimbi Adventist Hospital,Megabit,7,2009,88,32,97,217
Oromia,Burayu Town,Burayu Town,Nehase,12,2009,86,11,74,171
Oromia,Bale,Legehida,Tahesas,4,2010,86,76,16,178
Oromia,Horo Gudru Wellega,Gudru,Hedar,3,2011,42,59,44,145
Oromia,West Hararge,Burka Dimtu,Tir,5,2011,33,40,76,149
Oromia,West Wellega,Gimbi Adventist Hospital,Nehase,12,2009,41,63,58,162
Oromia,East Hararge,Babile Woreda,Tir,5,2010,23,27,40,90
Oromia,Bale,Meda Welabu,Tahesas,4,2010,11,86,72,169
Oromia,North Shewa,Aleiltu,Hedar,3,2010,10,75,66,151
Oromia,Arsi,Chole,Megabit,7,2009,10,86,89,185
Oromia,North Shewa,Kimbibit,Megabit,7,2010,17,62,93,172
Oromia,Jimma,B/Tolyi,Tahesas,4,2011,12,21,28,61
Oromia,Arsi,Digeluna Tijo,Yekatit,6,2010,86,14,89,189
Oromia,Jimma,Shabe,Hedar,3,2010,84,2,44,130
Oromia,Dukem Town,Dukem Town,Tir,5,2009,13,80,66,159
Oromia,East Wellega,Wayu Tuqa,Meskerem,1,2011,73,14,5,92
Oromia,Sululta Town,Sululta Town,Nehase,12,2010,9,57,49,115
Oromia,West Wellega,Gimbi Adventist Hospital,Meskerem,1,2010,85,91,58,234
Oromia,Ilu Aba Bora,Becho,Ginbot,9,2009,58,71,80,209
Oromia,West Wellega,Gimbi Adventist Hospital,Teqemt,2,2011,97,54,30,181
Oromia,West Hararge,Hawi Gudina,Yekatit,6,2009,39,61,92,192
Oromia,Jimma,Gera,Ginbot,9,2011,38,56,65,159
Oromia,East Shewa,Bora,Megabit,7,2009,37,68,46,151
Oromia,East Shewa,Olanciti Hospital,Miyazia,8,2009,27,6,6,39
Oromia,Bale,Dawe Serar,Tir,5,2010,80,44,99,223
Oromia,West Shewa,Midakegni,Tir,5,2010,71,69,34,174
Oromia,Adama Special Town,Adama Town,Teqemt,2,2010,96,85,28,209
Oromia,North Shewa,Jido,Hamle,11,2009,32,8,51,91
Oromia,Borena,Yabelo Hospital,Nehase,12,2010,82,18,55,155
Oromia,North Shewa,Kuyu Hospital,Sene,10,2011,98,7,11,116
Oromia,West Guji,Bule Hora Hospital,Hedar,3,2010,59,41,83,183
Oromia,North Shewa,Wuchale,Teqemt,2,2011,16,26,98,140
Oromia,West Hararge,Oda Bultum,Ginbot,9,2010,8,55,20,83
Oromia,Guji,Anna Sora,Miyazia,8,2011,3,18,34,55
Oromia,Borena,El Way,Meskerem,1,2011,90,52,10,152
Oromia,Horo Gudru Wellega,Shambu Hospital,Yekatit,6,2011,53,58,34,145
Oromia,East Wellega,Kiremu,Megabit,7,2010,17,2,57,76
Oromia,Borena,Arero,Megabit,7,2010,22,22,85,129
Oromia,Bale,Seweyna,Megabit,7,2011,53,6,33,92
Oromia,Jimma,Dedo,Miyazia,8,2009,96,36,67,199
Oromia,North Shewa,Kuyu,Hamle,11,2010,10,42,7,59
Oromia,West Shewa,Ejerie,Yekatit,6,2011,23,27,69,119
Oromia,West Hararge,West Harerge	Gumbi Bordede,Meskerem,1,2010,26,50,77,153
Oromia,Bale,Gasera,Nehase,12,2010,77,90,82,249
Oromia,Arsi,Hitosa,Tir,5,2011,14,23,58,95
Oromia,East Wellega,Limu,Meskerem,1,2010,73,6,26,105
Oromia,Horo Gudru Wellega,Horo,Teqemt,2,2010,1,46,29,76
Oromia,South West Shewa,Goro,Ginbot,9,2009,75,47,20,142
Oromia,West Hararge,Chiro Town,Hedar,3,2011,61,63,74,198
Oromia,Arsi,Amigna,Meskerem,1,2011,84,95,59,238
Oromia,Guji,Hambela Wamena,Sene,10,2010,63,71,2,136
Oromia,South West Shewa,Woliso Town,Tir,5,2009,49,50,46,145
Oromia,East Hararge,Chinakesen,Tir,5,2009,62,16,22,100
Oromia,Qeleme Wellega,Hawa Gelan,Meskerem,1,2011,49,50,57,156
Oromia,West Wellega,Homa,Megabit,7,2011,58,71,84,213
Oromia,Arsi,Tiyo,Ginbot,9,2010,86,85,29,200
Oromia,East Hararge,Deder,Megabit,7,2010,97,20,72,189
Oromia,East Wellega,Gida Ayana,Sene,10,2009,12,14,87,113
Oromia,West Shewa,Abuna Gindeberet,Meskerem,1,2010,69,35,9,113
Oromia,West Shewa,Ambo,Megabit,7,2010,13,17,6,36
Oromia,Buno Bedele,Chewaqa,Ginbot,9,2010,78,78,46,202
Oromia,Borena,El Way,Ginbot,9,2011,13,25,24,62
Oromia,Ilu Aba Bora,Bure,Teqemt,2,2010,82,3,20,105
Oromia,East Shewa,Mojo,Hamle,11,2009,42,96,87,225
Oromia,Qeleme Wellega,Hawa Gelan,Yekatit,6,2010,74,32,63,169
Oromia,Finfine Zuria,Mullo,Meskerem,1,2010,3,40,65,108
Oromia,Guji,Shakiso Town,Sene,10,2009,67,70,30,167
Oromia,East Hararge,Haromaya Rural,Nehase,12,2010,72,83,81,236
Oromia,East Wellega,Boneya Bushe,Tahesas,4,2010,46,95,1,142
Oromia,West Shewa,Midakegni,Teqemt,2,2010,76,16,59,151
Oromia,West Guji,Mkelka Soda,Tahesas,4,2011,7,20,1,28
Oromia,Borena,Arero,Tir,5,2009,91,79,75,245
Oromia,East Wellega,Guto Gida,Teqemt,2,2011,55,92,48,195
Oromia,West Hararge,Chiro Zuriya,Miyazia,8,2010,94,39,15,148
Oromia,Guji,Adola Town,Meskerem,1,2011,65,33,60,158
Oromia,West Shewa,Jeldu,Tir,5,2011,6,90,62,158
Oromia,Jimma,Agaro Hospital,Miyazia,8,2011,8,17,84,109
Oromia,East Hararge,Deder,Tahesas,4,2010,10,29,20,59
Oromia,West Wellega,Mendi Hospital,Nehase,12,2009,24,64,53,141
Oromia,West Shewa,Ambo,Miyazia,8,2010,72,28,28,128
Oromia,West Shewa,Midakegni,Megabit,7,2009,81,1,96,178
Oromia,Buno Bedele,Diga,Yekatit,6,2010,70,29,63,162
Oromia,West Arsi,Bishan Guracha Town,Meskerem,1,2010,0,51,4,55
Oromia,West Guji,Abaya,Sene,10,2010,87,17,92,196
Oromia,West Guji,Biebirsa Kojowa,Yekatit,6,2009,44,2,73,119
Oromia,Arsi,Tiyo,Megabit,7,2010,64,87,52,203
Oromia,West Hararge,Hawi Gudina,Sene,10,2011,65,43,20,128
Oromia,Horo Gudru Wellega,Hababo Guduru,Meskerem,1,2011,41,99,84,224
Oromia,West Wellega,Yubdo,Yekatit,6,2009,92,97,68,257
Oromia,Bale,Legehida,Teqemt,2,2010,69,14,28,111
Oromia,West Arsi,Wondo,Hedar,3,2011,86,97,44,227
Oromia,Buno Bedele,Dedesa,Ginbot,9,2011,36,90,46,172
Oromia,North Shewa,Dera,Ginbot,9,2011,31,65,75,171
Oromia,Borena,Moyale Hospital,Megabit,7,2010,62,41,22,125
Oromia,Assela Town,Assela Town,Miyazia,8,2011,40,87,6,133
Oromia,West Shewa,Tibe Kutaye,Tahesas,4,2011,73,24,0,97
Oromia,Buno Bedele,Chora,Miyazia,8,2011,12,30,87,129
Oromia,East Hararge,Bedeno,Yekatit,6,2009,78,58,76,212
Oromia,East Hararge,Kurfa Chele,Nehase,12,2010,15,59,22,96
Oromia,Bale,Delo Mena,Tir,5,2009,52,83,54,189
Oromia,South West Shewa,Ameya,Hamle,11,2010,30,23,89,142
Oromia,West Arsi,Hebal Arsi,Teqemt,2,2010,95,5,85,185
Oromia,Guji,Shakiso Town,Meskerem,1,2011,7,48,79,134
Oromia,Bale,Seweyna,Meskerem,1,2011,70,95,6,171
Oromia,Arsi,Robe,Yekatit,6,2011,93,88,63,244
Oromia,Guji,Bore,Sene,10,2010,46,21,37,104
Oromia,Jimma,Guma,Nehase,12,2010,23,23,79,125
Oromia,Bale,Agarfa,Yekatit,6,2011,96,59,49,204
Oromia,Guji,Shakiso Town,Ginbot,9,2011,1,9,80,90
Oromia,West Hararge,Habro,Nehase,12,2010,32,45,59,136
Oromia,Arsi,Sire,Teqemt,2,2011,3,66,47,116
Oromia,West Arsi,Nensebo,Sene,10,2011,5,11,37,53
Oromia,East Hararge,Deder,Ginbot,9,2010,35,89,92,216
Oromia,West Wellega,Boji Cheqorsa,Meskerem,1,2010,46,62,19,127
Oromia,East Wellega,Diga,Ginbot,9,2009,62,61,86,209
Oromia,Jimma,Gera,Hedar,3,2011,94,63,48,205
Oromia,Guji,Negele Town,Miyazia,8,2010,42,70,17,129
Oromia,Bale,Arena Buluq,Nehase,12,2010,64,90,75,229
Oromia,Buno Bedele,Dapho Hana,Tahesas,4,2010,58,34,2,94
Oromia,South West Shewa,Tulu Bolo Hospital,Megabit,7,2011,6,55,15,76
Oromia,West Shewa,Codi,Hedar,3,2011,79,71,74,224
Oromia,Sebeta Town,Sebeta Town,Miyazia,8,2011,62,96,89,247
Oromia,Bale,Robe Town,Miyazia,8,2009,54,57,24,135
Oromia,West Shewa,Adea Berga,Megabit,7,2010,51,22,88,161
Oromia,East Wellega,Gida Ayana,Megabit,7,2009,92,82,37,211
Oromia,Bale,Goro,Megabit,7,2010,95,90,12,197
Oromia,East Wellega,Gobu Seyo,Megabit,7,2010,6,1,56,63
Oromia,Guji,Adola Town,Yekatit,6,2009,3,87,86,176
Oromia,West Wellega,Jarso,Yekatit,6,2010,71,13,66,150
Oromia,Qeleme Wellega,Anfilo,Tir,5,2011,76,65,43,184
Oromia,Jimma,Mana,Teqemt,2,2010,60,33,54,147
Oromia,West Arsi,Kofele,Hedar,3,2011,40,7,88,135
Oromia,West Wellega,Begi Hospital,Hedar,3,2011,52,41,20,113
Oromia,West Guji,Bule Hora,Teqemt,2,2010,94,3,77,174
Oromia,Horo Gudru Wellega,Jima Rare,Sene,10,2009,36,92,31,159
Oromia,Borena,Dilo,Ginbot,9,2009,3,39,61,103
Oromia,Arsi,Guna,Tir,5,2009,76,28,55,159
Oromia,Guji,Negele Hospital,Meskerem,1,2011,22,81,44,147
Oromia,West Guji,Mkelka Soda,Yekatit,6,2009,72,97,49,218
Oromia,Jimma,Seka Chekorsa,Tir,5,2010,78,95,30,203
Oromia,Jimma,B/Tolyi,Tir,5,2011,93,37,61,191
Oromia,Jimma,Setema Hospital,Sene,10,2010,27,26,95,148
Oromia,Qeleme Wellega,Gidami Hosp,Ginbot,9,2011,27,54,82,163
Oromia,Guji,Adola Reda,Megabit,7,2009,91,57,15,163
Oromia,South West Shewa,Ilu,Miyazia,8,2011,7,83,27,117
Oromia,Buno Bedele,Chora,Teqemt,2,2011,26,24,85,135
Oromia,West Shewa,Dendi,Hamle,11,2010,54,7,2,63
Oromia,Bale,Gasera,Hamle,11,2009,37,48,74,159
Oromia,West Shewa,Metarobi,Nehase,12,2010,93,79,7,179
Oromia,Borena,Arero,Ginbot,9,2011,42,45,1,88
Oromia,West Hararge,Chiro Zuriya,Teqemt,2,2011,13,48,28,89
Oromia,East Wellega,Guto Gida,Meskerem,1,2010,36,35,18,89
Oromia,West Arsi,Bishan Guracha Town,Tir,5,2011,56,7,2,65
Oromia,West Shewa,Abuna Gindeberet,Hamle,11,2010,66,39,92,197
Oromia,West Hararge,Chiro Zuriya,Miyazia,8,2009,91,63,42,196
Oromia,East Wellega,Nunu Qumba,Hedar,3,2011,61,25,30,116
Oromia,East Wellega,Wayu Tuqa,Miyazia,8,2010,96,24,60,180
Oromia,West Shewa,Ilu Galan,Tir,5,2010,62,94,9,165
Oromia,East Wellega,Jimma Arjo,Tir,5,2009,88,24,72,184
Oromia,Finfine Zuria,Mullo,Megabit,7,2011,75,79,17,171
Oromia,Guji,Odo Shakiso,Sene,10,2011,96,28,95,219
Oromia,West Hararge,Chiro Town,Hedar,3,2011,10,70,68,148
Oromia,South West Shewa,Kersana Malima,Yekatit,6,2010,35,91,17,143
Oromia,West Wellega,Mendi Hospital,Yekatit,6,2009,76,17,1,94
Oromia,West Guji,Bule Hora,Miyazia,8,2010,91,89,80,260
Oromia,East Shewa,Lomme,Tahesas,4,2011,17,33,28,78
Oromia,West Wellega,Gimbi,Miyazia,8,2011,42,23,94,159
Oromia,Buno Bedele,Chora,Miyazia,8,2009,94,37,7,138
Oromia,West Guji,Biebirsa Kojowa,Sene,10,2009,27,49,53,129
Oromia,East Hararge,Chelenko Hospital,Teqemt,2,2011,82,25,25,132
Oromia,Bale,Ginir,Yekatit,6,2010,94,43,39,176
Oromia,East Wellega,Wama Hagelo,Hedar,3,2010,24,34,7,65
Oromia,Arsi,Robe,Nehase,12,2010,75,13,49,137
Oromia,Guji,Adola Town,Meskerem,1,2010,29,39,61,129
Oromia,Buno Bedele,Diga,Ginbot,9,2009,81,67,26,174
Oromia,Jimma,Gera,Tahesas,4,2011,39,47,40,126
Oromia,West Hararge,Anchar,Teqemt,2,2010,14,14,67,95
Oromia,Arsi,Gololcha,Megabit,7,2010,80,57,88,225
Oromia,West Shewa,Codi,Sene,10,2009,22,3,49,74
Oromia,South West Shewa,Goro,Ginbot,9,2009,19,78,40,137
Oromia,South West Shewa,Seden Sodo,Megabit,7,2009,59,15,82,156
Oromia,West Hararge,Chiro Town,Megabit,7,2009,95,30,19,144
Oromia,Qeleme Wellega,Hawa Gelan Hosp,Tahesas,4,2011,13,72,9,94
Oromia,Guji,Bore Hospital,Tahesas,4,2011,5,22,26,53
Oromia,East Hararge,Gole Oda,Yekatit,6,2010,91,94,57,242
Oromia,West Guji,Bule Hora Hospital,Yekatit,6,2009,8,46,0,54
Oromia,Jimma,Setema Hospital,Tir,5,2011,17,76,39,132
Oromia,West Shewa,Ambo Hospital,Tahesas,4,2010,86,76,84,246
Oromia,West Wellega,Mendi Hospital,Hedar,3,2010,25,87,67,179
Oromia,Ilu Aba Bora,Becho,Teqemt,2,2011,80,64,8,152
Oromia,West Arsi,Loke Hada Hospital,Ginbot,9,2011,82,86,66,234
Oromia,Guji,Saba Boru,Sene,10,2011,31,17,96,144
Oromia,Jimma,Shabe,Tir,5,2011,8,72,29,109
Oromia,Finfine Zuria,Sululta Town,Meskerem,1,2010,60,2,45,107
Oromia,West Wellega,Mene Sibu,Teqemt,2,2011,58,67,94,219
Oromia,West Wellega,Guliso,Hamle,11,2009,20,17,94,131
Oromia,West Wellega,Nejo Hospital,Hamle,11,2010,83,35,27,145
Oromia,East Hararge,Deder,Ginbot,9,2009,42,97,94,233
Oromia,West Shewa,Dano,Megabit,7,2010,19,93,18,130
Oromia,Guji,Anna Sora,Sene,10,2009,91,87,18,196
Oromia,Guji,Odo Shakiso,Ginbot,9,2011,80,31,24,135
Oromia,Guji,Gumi Eldallo,Meskerem,1,2010,57,76,94,227
Oromia,Arsi,Chole,Miyazia,8,2011,7,35,92,134
Oromia,Horo Gudru Wellega,Jima Geneti,Teqemt,2,2010,32,89,54,175
Oromia,West Wellega,Genji,Tir,5,2009,96,20,41,157
Oromia,Guji,Liben,Yekatit,6,2011,89,95,82,266
Oromia,East Wellega,Sasiga,Meskerem,1,2011,45,41,3,89
Oromia,West Wellega,Nole Kaba,Hedar,3,2011,74,31,12,117
Oromia,Arsi,Sude,Teqemt,2,2011,77,43,96,216
Oromia,West Hararge,Doba,Miyazia,8,2010,50,27,3,80
Oromia,Borena,Dilo,Teqemt,2,2011,9,77,38,124
Oromia,South West Shewa,Dawo,Yekatit,6,2010,58,0,71,129
Oromia,Bale,Dawe Qachen,Megabit,7,2010,2,21,44,67
Oromia,East Wellega,Haro Limu,Hedar,3,2011,76,92,45,213
Oromia,Finfine Zuria,Holeta,Yekatit,6,2009,15,56,12,83
Oromia,West Guji,Bule Hora Hospital,Sene,10,2009,86,54,24,164
Oromia,North Shewa,Kuyu,Teqemt,2,2011,54,85,6,145
Oromia,East Wellega,Gudeyabila,Megabit,7,2010,61,33,20,114
Oromia,West Hararge,Bedesa Town,Megabit,7,2009,52,30,62,144
Oromia,Guji,Shakiso Town,Megabit,7,2009,76,43,0,119
Oromia,North Shewa,Kuyu,Megabit,7,2009,58,85,0,143
Oromia,Bale,Goro,Nehase,12,2009,78,98,32,208
Oromia,East Wellega,Haro Limu,Yekatit,6,2011,17,21,17,55
Oromia,North Shewa,Yaya Gulele,Hedar,3,2011,29,80,12,121
Oromia,Borena,Gomole,Ginbot,9,2010,80,31,49,160
Oromia,Bale,Berbere,Megabit,7,2010,29,29,92,150
Oromia,West Shewa,Codi,Yekatit,6,2010,1,47,16,64
Oromia,South West Shewa,Ameya Hospital,Megabit,7,2010,72,65,74,211
Oromia,West Shewa,Ginde Beret,Sene,10,2009,21,54,31,106
Oromia,Guji,Odo Shakiso,Hedar,3,2011,20,52,60,132
Oromia,East Hararge,Aweday Town,Miyazia,8,2010,85,52,15,152
Oromia,East Wellega,Ebantu,Megabit,7,2011,29,22,98,149
Oromia,Finfine Zuria,Walmera,Meskerem,1,2010,83,61,40,184
Oromia,Qeleme Wellega,Dale Sedi,Megabit,7,2011,97,4,11,112
Oromia,South West Shewa,St.Luke Hospital,Yekatit,6,2011,79,56,35,170
Oromia,West Guji,Suro Barguda,Sene,10,2010,98,69,16,183
Oromia,South West Shewa,Ameya,Meskerem,1,2011,7,40,66,113
Oromia,West Shewa,Ginde Beret,Yekatit,6,2011,21,20,77,118
Oromia,East Wellega,Ebantu,Ginbot,9,2009,0,27,71,98
Oromia,East Hararge,Kumbi,Miyazia,8,2009,93,99,85,277
Oromia,East Shewa,Adama,Sene,10,2009,63,79,41,183
Oromia,Finfine Zuria,Sandefa,Hamle,11,2009,25,39,7,71
Oromia,Bale,Dawe Serar,Nehase,12,2009,60,12,59,131
Oromia,East Wellega,Limu,Megabit,7,2011,53,18,36,107
Oromia,West Shewa,Bako Hospital,Teqemt,2,2011,50,50,37,137
Oromia,Arsi,Shenan Kolu,Miyazia,8,2010,57,10,28,95
Oromia,East Hararge,Babile,Yekatit,6,2010,44,46,72,162
Oromia,West Shewa,Ilu Galan,Megabit,7,2011,52,29,32,113
Oromia,East Hararge,Fedis,Megabit,7,2011,68,29,42,139
Oromia,Ilu Aba Bora,Hurumu,Ginbot,9,2011,74,76,20,170
Oromia,West Shewa,Nono,Megabit,7,2009,20,30,33,83
Oromia,West Wellega,Jarso,Tir,5,2009,53,48,58,159
Oromia,Borena,Dubluk,Tir,5,2009,19,6,55,80
Oromia,East Wellega,Wama Hagelo,Nehase,12,2009,91,18,93,202
Oromia,South West Shewa,Tulu Bolo Hospital,Miyazia,8,2009,95,79,84,258
Oromia,West Wellega,Babo Gembel,Tir,5,2009,4,60,0,64
Oromia,Borena,Dire,Hedar,3,2010,93,82,52,227
Oromia,West Arsi,Shala,Megabit,7,2010,49,25,30,104
Oromia,Finfine Zuria,Berreh,Yekatit,6,2009,98,91,38,227
Oromia,Borena,Meyo,Hamle,11,2009,69,37,25,131
Oromia,Buno Bedele,Meko,Miyazia,8,2010,78,6,1,85
Oromia,East Hararge,Midega Tole,Teqemt,2,2011,37,98,42,177
Oromia,East Wellega,Guto Gida,Megabit,7,2009,23,64,62,149
Oromia,Borena,Wachile,Tahesas,4,2011,75,57,74,206
Oromia,Horo Gudru Wellega,Horo,Ginbot,9,2010,20,23,89,132
Oromia,West Hararge,Gemechis,Sene,10,2010,61,49,67,177
Oromia,Arsi,Limuna Bilbilo,Ginbot,9,2011,13,30,53,96
Oromia,West Arsi,Kore,Megabit,7,2010,99,19,42,160
Oromia,East Hararge,Kombolicha,Hamle,11,2010,66,17,90,173
Oromia,East Wellega,Jimma Arjo,Hamle,11,2010,52,12,78,142
Oromia,West Shewa,Inchini Hospital,Tir,5,2010,78,6,27,111
Oromia,Borena,Dubluk,Megabit,7,2009,83,9,77,169
Oromia,Guji,Odo Shakiso,Yekatit,6,2011,91,70,36,197
Oromia,Borena,Gomole,Nehase,12,2009,38,16,13,67
Oromia,Jimma,Gera,Nehase,12,2009,22,27,29,78
Oromia,South West Shewa,Sodo Dac'Ha,Hamle,11,2010,81,43,3,127
Oromia,Bale,Gura Dhamole,Meskerem,1,2010,22,61,14,97
Oromia,Horo Gudru Wellega,Abe Dengoro,Yekatit,6,2010,4,7,61,72
Oromia,Guji,Odo Shakiso,Ginbot,9,2009,29,75,23,127
Oromia,West Arsi,Wondo,Miyazia,8,2011,26,10,31,67
Oromia,West Arsi,Wondo,Sene,10,2009,84,51,61,196
Oromia,Guji,Aga Wayyu,Tahesas,4,2010,11,36,9,56
Oromia,West Shewa,Tibe Kutaye,Sene,10,2009,95,30,61,186
Oromia,Ilu Aba Bora,Algesachi,Nehase,12,2010,34,49,96,179
Oromia,Bale,Gura Dhamole,Hamle,11,2010,74,27,29,130
Oromia,Shashamane Town,Shashamane Town,Meskerem,1,2011,71,29,40,140
Oromia,Horo Gudru Wellega,Jarte Jardga,Megabit,7,2011,92,76,92,260
Oromia,Qeleme Wellega,Yemalogi Wolel,Hamle,11,2009,72,13,35,120
Oromia,East Wellega,Gobu Seyo,Teqemt,2,2011,65,45,77,187
Oromia,South West Shewa,Sodo Dac'Ha,Megabit,7,2009,33,20,76,129
Oromia,North Shewa,Debre Libanos,Hamle,11,2010,72,47,82,201
Oromia,East Hararge,Haromaya Town,Sene,10,2009,54,12,0,66
Oromia,Shashamane Town,Shashamane Town,Sene,10,2011,21,99,89,209
Oromia,West Hararge,Gelemso Hospital,Ginbot,9,2010,54,8,7,69
Oromia,West Arsi,Gambo Hospital,Meskerem,1,2010,22,80,17,119
Oromia,North Shewa,Abichugna,Teqemt,2,2011,14,28,68,110
Oromia,East Wellega,Boneya Bushe,Miyazia,8,2011,99,48,39,186
Oromia,West Wellega,Lalo Asabi,Megabit,7,2010,85,19,88,192
Oromia,Borena,Meyo,Ginbot,9,2010,65,74,78,217
Oromia,East Hararge,Haromaya Town,Nehase,12,2009,96,12,37,145
Oromia,Qeleme Wellega,Dale Sedi,Hedar,3,2011,95,57,23,175
Oromia,Arsi,Enkelo Wabe,Hamle,11,2010,6,16,13,35
Oromia,Guji,Negele Town,Tir,5,2010,70,86,55,211
Oromia,East Hararge,Meyu Muleke,Yekatit,6,2009,86,23,45,154
Oromia,Qeleme Wellega,Dale Sedi,Nehase,12,2009,71,26,11,108
Oromia,Horo Gudru Wellega,Horro Buluk,Megabit,7,2011,73,25,72,170
Oromia,West Wellega,Kundala,Tir,5,2010,4,42,36,82
Oromia,West Shewa,Gedo Hospital,Miyazia,8,2009,18,10,99,127
Oromia,West Wellega,Boji Dermeji,Teqemt,2,2011,19,45,95,159
Oromia,East Hararge,Girawa,Megabit,7,2009,95,55,53,203
Oromia,West Arsi,Dodola Town,Sene,10,2010,45,58,20,123
Oromia,East Wellega,Sasiga,Nehase,12,2010,14,84,77,175
Oromia,Bale,Goba Town,Ginbot,9,2010,14,91,2,107
Oromia,Horo Gudru Wellega,Abay Chomen,Tahesas,4,2010,36,31,97,164
Oromia,North Shewa,Yaya Gulele,Megabit,7,2009,42,9,79,130
Oromia,West Wellega,Nejo Town,Miyazia,8,2010,20,83,67,170
Oromia,East Shewa,Bora,Yekatit,6,2009,7,32,77,116
Oromia,North Shewa,Fiche Hospital,Meskerem,1,2010,9,23,80,112
Oromia,Bale,Dinsho,Hedar,3,2011,73,12,12,97
Oromia,West Hararge,Daro Lebu,Ginbot,9,2010,76,11,35,122
Oromia,West Wellega,Nejo Town,Miyazia,8,2010,21,41,68,130
Oromia,East Shewa,Lomme,Miyazia,8,2009,24,28,86,138
Oromia,North Shewa,Fichetown,Miyazia,8,2010,94,98,28,220
Oromia,East Hararge,Babile,Yekatit,6,2009,70,22,0,92
Oromia,Bale,Dawe Qachen,Ginbot,9,2011,46,38,46,130
Oromia,East Hararge,Kurfa Chele,Teqemt,2,2010,81,64,49,194
Oromia,East Hararge,Meta,Yekatit,6,2011,57,99,13,169
Oromia,West Arsi,Bishan Guracha Town,Tir,5,2009,90,48,20,158
Oromia,West Guji,Biebirsa Kojowa,Teqemt,2,2010,22,34,41,97
Oromia,Modjo Town,Modjo Town,Nehase,12,2010,22,56,43,121
Oromia,West Arsi,Shashemene Rural,Ginbot,9,2010,60,33,14,107
Oromia,West Wellega,Yubdo,Hedar,3,2010,86,9,59,154
Oromia,East Wellega,Gudeyabila,Sene,10,2009,19,92,58,169
Oromia,Jimma Spe Town,Jimma Spe Town,Tir,5,2009,67,99,29,195
Oromia,West Hararge,Hawi Gudina,Meskerem,1,2010,45,62,47,154
Oromia,Bale,Sinana,Hamle,11,2009,42,98,2,142
Oromia,Jimma,Guma,Hedar,3,2010,84,19,12,115
Oromia,East Shewa,Dugda,Hedar,3,2010,95,21,36,152
Oromia,South West Shewa,Seden Sodo,Megabit,7,2010,23,38,60,121
Oromia,West Arsi,Gambo Hospital,Megabit,7,2009,37,37,90,164
Oromia,Jimma,Dedo,Sene,10,2010,20,74,23,117
Oromia,Qeleme Wellega,Anfilo,Sene,10,2010,74,16,93,183
Oromia,West Shewa,Ginde Beret,Tahesas,4,2010,95,68,43,206
Oromia,South West Shewa,St.Luke Hospital,Miyazia,8,2009,45,52,0,97
Oromia,West Hararge,Daro Lebu,Megabit,7,2010,15,36,26,77
Oromia,Buno Bedele,Bedele Town,Ginbot,9,2009,91,67,41,199
Oromia,Borena,Yabelo,Nehase,12,2010,57,63,11,131
Oromia,Guji,Negele Hospital,Hamle,11,2010,18,31,92,141
Oromia,Nekemte Town,Nekemte Town,Teqemt,2,2011,84,24,35,143
Oromia,North Shewa,Yaya Gulele,Ginbot,9,2010,47,18,29,94
Oromia,Jimma,Setema,Hedar,3,2010,66,35,8,109
Oromia,Qeleme Wellega,Gawo Qebe,Miyazia,8,2009,63,58,30,151
Oromia,West Guji,Suro Barguda,Tir,5,2009,1,37,38,76
Oromia,Buno Bedele,Bedele Hospital,Ginbot,9,2011,30,31,29,90
Oromia,East Wellega,Gobu Seyo,Nehase,12,2009,24,39,13,76
Oromia,Bale,Raitu,Meskerem,1,2011,55,76,92,223
Oromia,West Shewa,Bako Tibe,Sene,10,2011,4,71,87,162
Oromia,North Shewa,Dera Hospital,Tir,5,2010,57,42,2,101
Oromia,West Shewa,Ginde Beret,Hamle,11,2009,73,2,48,123
Oromia,Ilu Aba Bora,Hurumu,Nehase,12,2009,77,33,38,148
Oromia,Burayu Town,Burayu Town,Nehase,12,2010,41,73,47,161
Oromia,Qeleme Wellega,Sedan Chanka,Megabit,7,2010,68,92,22,182
Oromia,Arsi,Tena,Tir,5,2010,66,23,35,124
Oromia,Qeleme Wellega,Dale Wabera,Ginbot,9,2011,3,18,96,117
Oromia,Finfine Zuria,Akaki,Nehase,12,2010,18,14,49,81
Oromia,Finfine Zuria,Sululta Town,Tir,5,2009,21,41,42,104
Oromia,Arsi,Robe,Miyazia,8,2011,64,22,51,137
Oromia,Buno Bedele,Gechi,Hedar,3,2010,3,82,61,146
Oromia,North Shewa,Fiche Hospital,Sene,10,2011,76,49,75,200
Oromia,West Wellega,Seyo Nole,Meskerem,1,2011,42,62,40,144
Oromia,West Wellega,Babo Gembel,Tir,5,2010,93,73,63,229
Oromia,West Arsi,Wondo,Hedar,3,2010,17,73,7,97
Oromia,West Arsi,Bishan Guracha Town,Megabit,7,2011,74,15,93,182
Oromia,Arsi,Shenan Kolu,Hedar,3,2011,46,36,48,130
Oromia,Qeleme Wellega,Dambi Dollo,Hamle,11,2010,36,29,29,94
Oromia,Borena,Wachile,Miyazia,8,2011,92,29,46,167
Oromia,Arsi,Merti,Hedar,3,2011,86,13,34,133
Oromia,South West Shewa,Kersana Malima,Meskerem,1,2011,43,49,83,175
Oromia,Arsi,Munesa,Tir,5,2010,78,39,85,202
Oromia,West Shewa,Bako Tibe,Megabit,7,2009,77,71,21,169
Oromia,East Hararge,Babile Woreda,Ginbot,9,2010,86,70,54,210
Oromia,Buno Bedele,Chora,Nehase,12,2009,15,86,41,142
Oromia,North Shewa,Aleiltu,Meskerem,1,2010,12,66,99,177
Oromia,East Hararge,Meyu Muleke,Tir,5,2011,41,89,6,136
Oromia,Arsi,Enkelo Wabe,Meskerem,1,2010,22,30,62,114
Oromia,Guji,Adola Town,Sene,10,2009,42,74,61,177
Oromia,North Shewa,Kuyu,Tir,5,2009,2,17,74,93
Oromia,Borena,Dilo,Ginbot,9,2011,52,39,57,148
Oromia,Ilu Aba Bora,Becho,Hedar,3,2011,29,30,86,145
Oromia,Arsi,Gololcha,Sene,10,2009,90,77,82,249
Oromia,West Wellega,Ayira Hospital,Miyazia,8,2011,36,45,71,152
Oromia,Borena,Dhas,Miyazia,8,2010,72,12,52,136
Oromia,East Wellega,Sibu Sire,Hamle,11,2009,16,90,97,203
Oromia,Horo Gudru Wellega,Shambu Town,Ginbot,9,2011,27,16,19,62
Oromia,Guji,Gumi Eldallo,Hamle,11,2009,74,3,5,82
Oromia,West Shewa,Ejerie,Yekatit,6,2010,96,78,48,222
Oromia,Arsi,Bale Gesgara,Sene,10,2010,13,94,28,135
Oromia,Guji,Negele Town,Tahesas,4,2011,8,23,95,126
Oromia,West Arsi,Bishan Guracha Town,Ginbot,9,2010,1,58,90,149
Oromia,Bale,Dinsho,Megabit,7,2009,98,80,40,218
Oromia,Borena,Dubluk,Tahesas,4,2011,71,83,31,185
Oromia,Bale,Seweyna,Teqemt,2,2010,11,59,60,130
Oromia,South West Shewa,Woliso Rural,Nehase,12,2010,44,67,87,198
Oromia,Qeleme Wellega,Gawo Qebe,Ginbot,9,2011,35,95,56,186
Oromia,Arsi,Ludehetosa,Hamle,11,2009,44,94,45,183
Oromia,West Wellega,Genji,Hedar,3,2010,47,93,38,178
Oromia,Ilu Aba Bora,Halu,Tir,5,2010,72,13,72,157
Oromia,West Arsi,Dodola Rural,Megabit,7,2009,28,61,4,93
Oromia,Arsi,Bekoji Town,Hedar,3,2010,54,82,15,151
Oromia,Horo Gudru Wellega,Jima Geneti,Nehase,12,2009,29,44,84,157
Oromia,South West Shewa,Woliso Rural,Ginbot,9,2011,88,18,16,122
Oromia,South West Shewa,Becho,Nehase,12,2010,82,93,39,214
Oromia,East Shewa,Liben,Meskerem,1,2011,29,91,49,169
Oromia,Ilu Aba Bora,Metu Town,Nehase,12,2009,54,21,58,133
Oromia,South West Shewa,Dawo,Sene,10,2010,16,42,91,149
Oromia,Horo Gudru Wellega,Horo,Miyazia,8,2011,54,74,42,170
Oromia,Arsi,Sude,Meskerem,1,2010,83,90,97,270
Oromia,Guji,Dima,Meskerem,1,2010,96,35,3,134
Oromia,East Shewa,Lomme,Sene,10,2011,53,69,86,208
Oromia,North Shewa,Aleiltu,Sene,10,2010,40,13,44,97
Oromia,East Shewa,Lomme,Ginbot,9,2011,0,12,97,109
Oromia,Guji,Dima,Megabit,7,2011,44,66,7,117
Oromia,East Hararge,Aweday Town,Sene,10,2009,12,21,31,64
Oromia,West Guji,Gelana,Miyazia,8,2011,45,18,87,150
Oromia,West Hararge,West Harerge	Gumbi Bordede,Nehase,12,2010,56,67,53,176
Oromia,East Shewa,Gimbichu,Ginbot,9,2011,69,30,92,191
Oromia,West Guji,Suro Barguda,Megabit,7,2009,82,29,69,180
Oromia,West Hararge,Doba,Megabit,7,2010,48,68,72,188
Oromia,West Wellega,Babo Gembel,Hedar,3,2011,16,52,33,101
Oromia,Qeleme Wellega,Hawa Gelan,Ginbot,9,2009,35,0,92,127
Oromia,South West Shewa,Bantu  Hospital,Hedar,3,2011,92,3,82,177
Oromia,Arsi,Shenan Kolu,Teqemt,2,2011,34,13,32,79
Oromia,Guji,Adola Reda,Megabit,7,2009,13,63,17,93
Oromia,Ilu Aba Bora,Didu,Hamle,11,2010,28,62,94,184
Oromia,Horo Gudru Wellega,Abay Chomen,Megabit,7,2010,83,50,31,164
Oromia,West Hararge,West Harerge	Gumbi Bordede,Hamle,11,2010,86,71,96,253
Oromia,East Hararge,Kumbi,Teqemt,2,2011,96,54,83,233
Oromia,East Shewa,Fentale,Sene,10,2011,30,54,62,146
Oromia,South West Shewa,Woliso Town,Nehase,12,2009,46,60,65,171
Oromia,West Wellega,Nole Kaba,Hamle,11,2010,15,61,87,163
Oromia,Horo Gudru Wellega,Amuru,Yekatit,6,2010,6,37,27,70
Oromia,East Wellega,Limu,Megabit,7,2011,45,62,5,112
Oromia,West Wellega,Yubdo,Teqemt,2,2010,38,76,24,138
Oromia,Ilu Aba Bora,Metu Rural,Sene,10,2010,83,67,13,163
Oromia,Finfine Zuria,Sebeta Awas,Sene,10,2010,86,88,71,245
Oromia,West Shewa,Dendi,Megabit,7,2009,65,9,14,88
Oromia,Guji,Bore,Nehase,12,2010,68,25,38,131
Oromia,East Wellega,Jimma Arjo,Nehase,12,2009,55,55,98,208
Oromia,Borena,Moyale Hospital,Teqemt,2,2011,75,23,30,128
Oromia,Jimma,O/Beyam,Hedar,3,2011,64,84,63,211
Oromia,East Hararge,Meyu Muleke,Ginbot,9,2010,91,22,13,126
Oromia,West Guji,Hanbala,Miyazia,8,2009,51,69,7,127
Oromia,South West Shewa,Becho,Miyazia,8,2010,7,97,76,180
Oromia,West Wellega,Nejo Town,Megabit,7,2009,51,83,47,181
Oromia,West Shewa,Inchini Hospital,Megabit,7,2009,75,95,24,194
Oromia,East Wellega,Kiremu,Tahesas,4,2011,53,53,63,169
Oromia,Buno Bedele,Dedesa,Tir,5,2011,75,52,75,202
Oromia,West Wellega,Mendi Town,Megabit,7,2010,40,59,35,134
Oromia,North Shewa,Kuyu Hospital,Miyazia,8,2010,14,86,60,160
Oromia,East Hararge,Chinakesen,Megabit,7,2010,40,56,67,163
Oromia,Buno Bedele,Bedele Zuriya,Teqemt,2,2011,96,99,25,220
Oromia,Buno Bedele,Bedele Hospital,Miyazia,8,2011,53,16,11,80
Oromia,Buno Bedele,Bedele Town,Hedar,3,2011,77,83,69,229
Oromia,South West Shewa,Tole,Hamle,11,2010,90,50,37,177
Oromia,East Hararge,Meta,Nehase,12,2010,93,39,48,180
Oromia,West Wellega,Guliso,Ginbot,9,2009,33,24,89,146
Oromia,West Shewa,Dano,Hamle,11,2009,15,64,94,173
Oromia,West Hararge,Mesela,Megabit,7,2011,63,4,26,93
Oromia,Horo Gudru Wellega,Abay Chomen,Miyazia,8,2009,79,52,90,221
Oromia,West Arsi,Dodola Town,Hedar,3,2011,87,5,75,167
Oromia,West Arsi,Siraro,Miyazia,8,2010,23,58,32,113
Oromia,Nekemte Town,Nekemte Town,Hedar,3,2011,90,56,33,179
Oromia,Guji,Dima,Hedar,3,2010,91,54,91,236
Oromia,South West Shewa,Kersana Malima,Yekatit,6,2009,57,13,54,124
Oromia,South West Shewa,Wonchi,Meskerem,1,2011,13,87,49,149
Oromia,West Hararge,Mesela,Ginbot,9,2011,81,26,94,201
Oromia,Qeleme Wellega,Dambi Dollo,Ginbot,9,2009,58,22,90,170
Oromia,South West Shewa,Ilu,Nehase,12,2009,64,69,74,207
Oromia,Jimma,Tiro Afeta,Hamle,11,2010,43,61,80,184
Oromia,Guji,Adola Hospital,Yekatit,6,2010,11,76,82,169
Oromia,Qeleme Wellega,Anfilo,Ginbot,9,2010,23,43,38,104
Oromia,West Shewa,Ilu Galan,Megabit,7,2009,18,11,24,53
Oromia,North Shewa,Girar Jarso,Tir,5,2009,58,76,42,176
Oromia,West Wellega,Ayira Hospital,Megabit,7,2009,53,11,6,70
Oromia,East Shewa,Liben,Tir,5,2009,79,9,15,103
Oromia,Jimma,Mancho,Hamle,11,2010,56,69,12,137
Oromia,West Hararge,Boke,Ginbot,9,2010,0,20,98,118
Oromia,East Hararge,Kurfa Chele,Hamle,11,2009,21,18,32,71
Oromia,Qeleme Wellega,Jimma Horo,Tir,5,2011,88,11,94,193
Oromia,Ilu Aba Bora,Halu,Hamle,11,2010,60,10,4,74
Oromia,Jimma,Limu Kosa,Hamle,11,2010,92,48,58,198
Oromia,Guji,Bore,Tir,5,2010,16,11,49,76
Oromia,West Arsi,Arsi Negele Town,Megabit,7,2009,85,62,19,166
Oromia,East Wellega,Gobu Seyo,Meskerem,1,2011,66,63,12,141
Oromia,Buno Bedele,Bedele Hospital,Ginbot,9,2010,30,9,96,135
Oromia,West Shewa,Gojo Hospital,Sene,10,2011,0,16,57,73
Oromia,North Shewa,Dera Hospital,Teqemt,2,2010,68,30,14,112
Oromia,Qeleme Wellega,Hawa Gelan,Nehase,12,2009,30,86,59,175
Oromia,East Hararge,Chinakesen,Hedar,3,2010,69,79,42,190
Oromia,Arsi,Deksis,Yekatit,6,2010,15,62,75,152
Oromia,Jimma,Omonada,Meskerem,1,2010,11,26,36,73
Oromia,West Wellega,Mene Sibu,Miyazia,8,2011,22,25,34,81
Oromia,Ilu Aba Bora,Doreni,Miyazia,8,2009,75,59,95,229
Oromia,Ilu Aba Bora,Bure,Hedar,3,2011,57,84,1,142
Oromia,East Wellega,Leqa Dulecha,Yekatit,6,2009,42,78,75,195
Oromia,Finfine Zuria,Sebeta Awas,Hamle,11,2010,58,53,59,170
Oromia,East Hararge,Midega Tole,Ginbot,9,2009,69,80,43,192
Oromia,East Hararge,Meta,Sene,10,2011,96,23,17,136
Oromia,Borena,El Way,Teqemt,2,2011,28,23,32,83
Oromia,West Arsi,Shala,Tir,5,2011,70,42,32,144
Oromia,Bale,Dawe Serar,Yekatit,6,2010,35,69,97,201
Oromia,West Hararge,Habro,Sene,10,2009,54,88,15,157
Oromia,Finfine Zuria,Berreh,Tir,5,2010,87,68,64,219
Oromia,East Hararge,Gursum,Tir,5,2011,40,28,72,140
Oromia,West Shewa,Bako Tibe,Megabit,7,2011,99,87,77,263
Oromia,Arsi,Digeluna Tijo,Tahesas,4,2010,5,75,8,88
Oromia,West Arsi,Arsi Negele Rural,Megabit,7,2009,2,72,20,94
Oromia,Jimma,Sigmo,Ginbot,9,2009,95,69,79,243
Oromia,West Wellega,Seyo Nole,Megabit,7,2011,30,46,25,101
Oromia,West Arsi,Dodola Rural,Sene,10,2011,50,88,95,233
Oromia,Arsi,Dodota,Yekatit,6,2011,44,30,76,150
Oromia,Horo Gudru Wellega,Jima Geneti,Yekatit,6,2010,90,53,67,210
Oromia,West Wellega,Gimbi Public  Hospital,Hamle,11,2010,7,98,82,187
Oromia,West Shewa,Abuna Gindeberet,Miyazia,8,2009,91,99,81,271
Oromia,West Shewa,Tikur Enchini,Yekatit,6,2009,75,1,73,149
Oromia,East Wellega,Jimma Arjo,Hedar,3,2010,63,84,72,219
Oromia,Finfine Zuria,Mullo,Yekatit,6,2010,76,23,39,138
Oromia,West Hararge,Hawi Gudina,Megabit,7,2011,92,64,8,164
Oromia,South West Shewa,Becho,Tahesas,4,2010,5,89,7,101
Oromia,East Hararge,Gursum,Sene,10,2011,44,72,20,136
Oromia,Qeleme Wellega,Anfilo,Hedar,3,2011,20,4,27,51
Oromia,Ilu Aba Bora,Ale,Yekatit,6,2009,91,44,38,173
Oromia,East Hararge,Kurfa Chele,Sene,10,2010,94,46,96,236
Oromia,East Hararge,Gursum,Tahesas,4,2011,46,72,94,212
Oromia,West Arsi,Gambo Hospital,Meskerem,1,2011,20,19,36,75
Oromia,Ambo Town,Ambo Town,Hamle,11,2010,57,98,49,204
Oromia,East Hararge,Babile Woreda,Miyazia,8,2011,98,97,30,225
Oromia,Assela Town,Assela Town,Tir,5,2010,22,59,49,130
Oromia,Bale,Ginir Town,Sene,10,2010,79,54,6,139
Oromia,Guji,Aga Wayyu,Hamle,11,2010,30,25,47,102
Oromia,Horo Gudru Wellega,Chomen Guduru,Tahesas,4,2011,7,83,66,156
Oromia,East Hararge,Jarso,Sene,10,2011,40,78,94,212
Oromia,Guji,Negele Town,Megabit,7,2011,68,9,61,138
Oromia,West Hararge,Tulo,Sene,10,2009,30,82,17,129
Oromia,East Hararge,Meyu Muleke,Miyazia,8,2009,42,4,45,91
Oromia,Ilu Aba Bora,Didu,Nehase,12,2009,1,16,71,88
Oromia,Arsi,Shirka,Sene,10,2009,70,7,64,141
Oromia,West Hararge,Anchar,Megabit,7,2010,87,8,0,95
Oromia,West Hararge,Chiro Hospital,Hamle,11,2009,68,7,90,165
Oromia,Jimma,Seka Chekorsa,Yekatit,6,2010,66,22,35,123
Oromia,East Wellega,Boneya Bushe,Sene,10,2009,83,11,12,106
Oromia,Bale,Ginir Town,Sene,10,2009,75,96,5,176
Oromia,Guji,Wadara,Meskerem,1,2011,37,9,8,54
Oromia,Borena,Yabelo,Ginbot,9,2011,3,52,58,113
Oromia,West Wellega,Boji Cheqorsa,Sene,10,2010,19,4,36,59
Oromia,West Guji,Bule Hora,Megabit,7,2010,68,78,74,220
Oromia,Nekemte Town,Nekemte Town,Teqemt,2,2011,42,28,38,108
Oromia,West Hararge,Bedesa Town,Tir,5,2011,53,80,58,191
Oromia,Finfine Zuria,Sebeta Awas,Hedar,3,2010,2,31,84,117
Oromia,East Hararge,Midega Tole,Meskerem,1,2011,46,12,23,81
Oromia,Arsi,Chole,Tir,5,2009,39,47,65,151
Oromia,West Arsi,Dodola Town,Tir,5,2009,7,29,3,39
Oromia,West Wellega,Haru,Meskerem,1,2010,21,41,45,107
Oromia,Bale,Berbere,Meskerem,1,2011,66,29,67,162
Oromia,East Hararge,Haromaya Rural,Miyazia,8,2011,75,4,58,137
Oromia,Jimma,Limu Hospital,Tahesas,4,2011,76,44,20,140
Oromia,East Hararge,Bedeno,Megabit,7,2010,22,69,6,97
Oromia,Horo Gudru Wellega,Jarte Jardga,Sene,10,2010,13,26,7,46
Oromia,South West Shewa,Goro,Meskerem,1,2010,9,71,34,114
Oromia,East Hararge,Midega Tole,Teqemt,2,2010,33,32,58,123
Oromia,South West Shewa,Goro,Hedar,3,2010,68,71,66,205
Oromia,South West Shewa,Dawo,Yekatit,6,2011,68,80,84,232
Oromia,West Hararge,Mesela,Nehase,12,2009,35,36,40,111
Oromia,South West Shewa,Woliso Rural,Sene,10,2010,48,76,91,215
Oromia,Jimma,Dedo,Megabit,7,2011,92,2,93,187
Oromia,East Wellega,Guto Gida,Megabit,7,2010,64,80,91,235
Oromia,East Hararge,Deder,Sene,10,2010,94,69,59,222
Oromia,North Shewa,Jido,Hamle,11,2009,17,46,74,137
Oromia,West Shewa,Bako Hospital,Tahesas,4,2011,83,68,34,185
Oromia,West Hararge,West Harerge	Gumbi Bordede,Tir,5,2010,88,22,97,207
Oromia,West Shewa,Jibat,Megabit,7,2010,7,39,81,127
Oromia,Ilu Aba Bora,Algesachi,Tahesas,4,2011,51,2,17,70
Oromia,Qeleme Wellega,Jimma Horo,Megabit,7,2010,87,67,50,204
Oromia,West Shewa,Bako Hospital,Nehase,12,2010,21,22,38,81
Oromia,East Hararge,Chelenko Hospital,Tir,5,2009,59,32,7,98
Oromia,West Hararge,Bedesa Town,Tir,5,2009,43,30,24,97
Oromia,Jimma,Shabe,Tir,5,2010,66,92,43,201
Oromia,Guji,Negele Town,Yekatit,6,2009,88,35,23,146
Oromia,Borena,Yabelo,Ginbot,9,2009,57,94,40,191
Oromia,Qeleme Wellega,Hawa Gelan Hosp,Yekatit,6,2011,93,71,77,241
Oromia,South West Shewa,Wonchi,Tir,5,2011,69,4,8,81
Oromia,West Hararge,Mesela,Yekatit,6,2010,18,31,83,132
Oromia,West Hararge,Bedesa Town,Meskerem,1,2011,85,19,50,154
Oromia,Jimma,Omo Nada Hospital,Teqemt,2,2011,27,23,93,143
Oromia,East Shewa,Adama,Miyazia,8,2009,49,33,95,177
Oromia,East Hararge,Girawa,Nehase,12,2009,86,27,17,130
Oromia,Ilu Aba Bora,Nono Sele,Miyazia,8,2009,71,91,91,253
Oromia,Ilu Aba Bora,Hurumu,Meskerem,1,2011,84,23,79,186
Oromia,Bale,Delo Mena,Tir,5,2010,43,11,45,99
Oromia,Jimma,Gomma,Ginbot,9,2010,87,61,79,227
Oromia,West Wellega,Ayira Hospital,Tahesas,4,2010,20,23,77,120
Oromia,East Wellega,Gobu Seyo,Sene,10,2009,52,44,34,130
Oromia,Horo Gudru Wellega,Gudru,Ginbot,9,2009,10,0,26,36
Oromia,Guji,Girja,Tahesas,4,2010,84,43,16,143
Oromia,East Wellega,Leqa Dulecha,Teqemt,2,2010,4,69,76,149
Oromia,Finfine Zuria,Berreh,Tir,5,2009,9,79,8,96
Oromia,Qeleme Wellega,Hawa Gelan Hosp,Megabit,7,2011,41,31,35,107
Oromia,West Guji,Kercha,Sene,10,2010,63,31,55,149
Oromia,West Shewa,Chelia,Ginbot,9,2010,78,66,72,216
Oromia,West Arsi,Dodola Rural,Megabit,7,2009,6,27,67,100
Oromia,Woliso Town,Woliso Town,Hedar,3,2010,33,45,66,144
Oromia,Ilu Aba Bora,Ale,Hedar,3,2011,29,54,22,105
Oromia,East Hararge,Kersa Eh,Tir,5,2011,71,19,87,177
Oromia,Qeleme Wellega,Dambi Dolo Hospital,Ginbot,9,2009,26,18,48,92
Oromia,East Shewa,Olanciti Hospital,Meskerem,1,2010,54,62,81,197
Oromia,Sebeta Town,Sebeta Town,Hedar,3,2010,87,22,15,124
Oromia,South West Shewa,Goro,Yekatit,6,2010,4,49,93,146
Oromia,Finfine Zuria,Mullo,Sene,10,2009,26,36,38,100
Oromia,West Shewa,Bako Hospital,Miyazia,8,2011,66,54,49,169
Oromia,East Wellega,Boneya Bushe,Hamle,11,2009,88,21,56,165
Oromia,Ilu Aba Bora,Yayu,Hamle,11,2010,79,15,32,126
Oromia,Arsi,Digeluna Tijo,Tir,5,2010,54,57,0,111
Oromia,Horo Gudru Wellega,Gudru,Megabit,7,2011,61,96,45,202
Oromia,Jimma,Setema,Megabit,7,2009,90,47,70,207
Oromia,West Shewa,Liban Jawi,Nehase,12,2010,31,12,70,113
Oromia,Arsi,Bale Gesgara,Tahesas,4,2011,92,54,66,212
Oromia,West Hararge,Boke,Nehase,12,2010,66,25,18,109
Oromia,Jimma,B/Tolyi,Megabit,7,2009,49,0,56,105
Oromia,West Wellega,Genji,Tahesas,4,2011,8,74,12,94
Oromia,West Arsi,Bishan Guracha Town,Megabit,7,2010,6,83,54,143
Oromia,West Arsi,Siraro,Yekatit,6,2009,15,46,41,102
Oromia,Finfine Zuria,Akaki,Meskerem,1,2010,76,12,79,167
Oromia,West Wellega,Nejo Rural,Ginbot,9,2010,86,79,80,245
Oromia,East Shewa,Gimbichu,Sene,10,2010,93,28,50,171
Oromia,East Wellega,Kiremu,Megabit,7,2010,23,52,21,96
Oromia,East Shewa,Adea,Meskerem,1,2010,67,16,17,100
Oromia,Arsi,Zeway Dugda,Hamle,11,2009,33,34,34,101
Oromia,Finfine Zuria,Holeta,Hamle,11,2009,42,25,62,129
Oromia,East Hararge,Haromaya Rural,Tir,5,2009,8,10,6,24
Oromia,Lege Dadi Lege Tafo Town,Lege Dadi Lege Tafo Town,Hedar,3,2011,76,87,29,192
Oromia,Finfine Zuria,Sululta Town,Hamle,11,2010,75,1,18,94
Oromia,West Arsi,Arsi Negele Town,Meskerem,1,2011,24,17,83,124
Oromia,West Hararge,West Harerge	Gumbi Bordede,Yekatit,6,2010,0,38,28,66
Oromia,Jimma,Nono Benja,Tahesas,4,2011,73,9,80,162
Oromia,East Wellega,Guto Gida,Teqemt,2,2010,61,91,52,204
Oromia,East Wellega,Gobu Seyo,Yekatit,6,2010,80,49,73,202
Oromia,Jimma,Limu Hospital,Hamle,11,2009,40,17,71,128
Oromia,East Shewa,Lomme,Miyazia,8,2010,59,6,91,156
Oromia,Bale,Dinsho,Sene,10,2009,95,18,81,194
Oromia,Woliso Town,Woliso Town,Meskerem,1,2011,32,70,80,182
Oromia,West Shewa,Guder Hosp,Nehase,12,2009,46,53,58,157
Oromia,West Guji,Bule Hora Toun,Hedar,3,2011,33,84,27,144
Oromia,East Hararge,Chelenko Hospital,Nehase,12,2009,40,12,85,137
Oromia,East Hararge,Deder,Megabit,7,2011,56,96,39,191
Oromia,East Hararge,Haromaya Town,Yekatit,6,2010,11,5,39,55
Oromia,West Wellega,Nole Kaba,Meskerem,1,2011,60,32,50,142
Oromia,Arsi,Tiyo,Tahesas,4,2011,50,0,40,90
Oromia,West Arsi,Dodola Town,Meskerem,1,2010,33,38,1,72
Oromia,Holeta Town,Holeta Town,Hedar,3,2011,70,2,74,146
Oromia,Jimma,Dedo,Teqemt,2,2011,13,17,64,94
Oromia,West Hararge,Chiro Hospital,Miyazia,8,2011,3,41,26,70
Oromia,North Shewa,Hidabu Abote,Hamle,11,2009,87,73,80,240
Oromia,West Shewa,Midakegni,Yekatit,6,2010,63,16,34,113
Oromia,East Shewa,Dugda,Nehase,12,2009,48,87,16,151
Oromia,East Wellega,Guto Gida,Tir,5,2010,51,34,85,170
Oromia,Arsi,Shirka,Hedar,3,2011,25,8,49,82
Oromia,West Shewa,Dano,Nehase,12,2009,24,78,79,181
Oromia,North Shewa,Debre Libanos,Teqemt,2,2010,26,56,41,123
Oromia,West Wellega,Ayira,Hedar,3,2010,88,34,32,154
Oromia,West Wellega,Gimbi Public  Hospital,Tir,5,2011,1,11,87,99
Oromia,Qeleme Wellega,Dale Wabera,Nehase,12,2009,80,72,35,187
Oromia,South West Shewa,Tulu Bolo Hospital,Miyazia,8,2010,11,95,34,140
Oromia,Ilu Aba Bora,Ale,Hedar,3,2010,82,75,53,210
Oromia,East Shewa,Batu,Ginbot,9,2010,66,98,13,177
Oromia,West Shewa,Gedo Hospital,Yekatit,6,2010,77,93,90,260
Oromia,West Guji,Abaya,Hamle,11,2009,2,94,11,107
Oromia,West Shewa,Nono,Meskerem,1,2010,61,92,67,220
Oromia,Arsi,Munesa,Sene,10,2009,32,82,18,132
Oromia,Bale,Delo Mena,Teqemt,2,2011,44,64,27,135
Oromia,West Hararge,Tulo,Teqemt,2,2011,61,20,48,129
Oromia,North Shewa,Yaya Gulele,Yekatit,6,2010,95,65,46,206
Oromia,Jimma,Limu Seka,Miyazia,8,2010,19,23,85,127
Oromia,Finfine Zuria,Sebeta Awas,Teqemt,2,2011,92,70,85,247
Oromia,West Wellega,Lata Sibu,Sene,10,2011,22,44,88,154
Oromia,West Hararge,Chiro Hospital,Hedar,3,2011,71,14,55,140
Oromia,East Shewa,Bora,Tahesas,4,2010,53,98,42,193
Oromia,Holeta Town,Holeta Town,Ginbot,9,2011,71,0,67,138
Oromia,West Guji,Dugda Dawa,Megabit,7,2009,23,58,25,106
Oromia,West Wellega,Genji,Nehase,12,2010,26,23,70,119
Oromia,Borena,Moyale,Hamle,11,2010,34,36,22,92
Oromia,Guji,Adola Reda,Ginbot,9,2010,19,47,33,99
Oromia,Borena,Moyale,Ginbot,9,2009,70,88,10,168
Oromia,Buno Bedele,Meko,Tahesas,4,2011,78,65,41,184
Oromia,East Wellega,Jimma Arjo,Yekatit,6,2010,25,8,1,34
Oromia,Buno Bedele,Dedesa,Megabit,7,2010,44,47,73,164
Oromia,Arsi,Guna,Ginbot,9,2009,89,68,14,171
Oromia,Jimma,Mancho,Yekatit,6,2010,60,4,68,132
Oromia,East Hararge,Kombolicha,Hedar,3,2011,27,82,53,162
Oromia,Bale,Gasera,Megabit,7,2009,1,77,25,103
Oromia,West Guji,Mkelka Soda,Ginbot,9,2010,11,63,22,96
Oromia,Ilu Aba Bora,Halu,Ginbot,9,2010,96,0,87,183
Oromia,West Arsi,Gambo Hospital,Tahesas,4,2011,29,8,84,121
Oromia,Qeleme Wellega,Anfilo,Sene,10,2009,35,98,84,217
Oromia,South West Shewa,Ameya Hospital,Megabit,7,2011,50,63,99,212
Oromia,Qeleme Wellega,Gawo Qebe,Nehase,12,2009,43,90,27,160
Oromia,Bale,Goba Town,Miyazia,8,2011,74,93,18,185
Oromia,Ilu Aba Bora,Metu Rural,Sene,10,2009,54,3,16,73
Oromia,Guji,Shakiso Town,Hamle,11,2010,77,12,28,117
Oromia,West Shewa,Bako Tibe,Yekatit,6,2010,40,25,88,153
Oromia,Borena,Guchi,Megabit,7,2009,95,47,28,170
Oromia,East Hararge,Fedis,Miyazia,8,2009,14,34,11,59
Oromia,Borena,El Way,Tir,5,2011,11,34,23,68
Oromia,West Shewa,Ambo Hospital,Sene,10,2011,54,5,99,158
Oromia,Guji,Goro Dola,Meskerem,1,2010,62,26,91,179
Oromia,West Shewa,Gindeberet Hospital,Teqemt,2,2011,17,35,26,78
Oromia,West Hararge,Meiso,Megabit,7,2009,63,95,68,226
Oromia,West Arsi,Wondo,Meskerem,1,2010,18,97,11,126
Oromia,North Shewa,Dera,Tir,5,2010,96,72,38,206
Oromia,East Hararge,Haromaya Town,Tir,5,2011,42,61,3,106
Oromia,East Shewa,Olanciti Hospital,Hamle,11,2009,57,16,60,133
Oromia,West Wellega,Nejo Hospital,Meskerem,1,2011,26,56,91,173
Oromia,West Hararge,Gemechis,Miyazia,8,2009,70,51,97,218
Oromia,East Hararge,Chelenko Hospital,Teqemt,2,2011,92,68,15,175
Oromia,Bale,Goro,Miyazia,8,2010,0,65,24,89
Oromia,Arsi,Amigna,Megabit,7,2009,2,57,49,108
Oromia,East Hararge,Deder,Ginbot,9,2009,15,84,29,128
Oromia,East Wellega,Kiremu,Ginbot,9,2011,18,16,74,108
Oromia,Arsi,Munesa,Hedar,3,2011,88,77,95,260
Oromia,East Wellega,Gida Ayana,Teqemt,2,2011,60,97,41,198
Oromia,Bale,Berbere,Sene,10,2011,25,22,66,113
Oromia,Finfine Zuria,Mullo,Tir,5,2009,5,62,62,129
Oromia,West Shewa,Jeldu,Nehase,12,2010,1,13,60,74
Oromia,West Wellega,Seyo Nole,Megabit,7,2010,73,93,41,207
Oromia,East Hararge,Chelenko Hospital,Sene,10,2010,86,7,74,167
Oromia,West Shewa,Codi,Megabit,7,2011,53,44,60,157
Oromia,West Arsi,Dodola Town,Miyazia,8,2011,66,3,68,137
Oromia,Buno Bedele,Chewaqa,Tahesas,4,2010,56,52,41,149
Oromia,North Shewa,Were Jarso,Tir,5,2011,70,89,31,190
Oromia,Bishoftu Town,Bishoftu Town,Sene,10,2010,3,92,18,113
Oromia,East Hararge,Jarso,Miyazia,8,2009,47,13,54,114
Oromia,East Shewa,Gimbichu,Hedar,3,2010,4,7,65,76
Oromia,Arsi,Deksis,Ginbot,9,2010,34,93,83,210
Oromia,Borena,Dubluk,Ginbot,9,2011,75,21,95,191
Oromia,Jimma Spe Town,Jimma Spe Town,Yekatit,6,2010,30,98,91,219
Oromia,Arsi,Bale Gesgara,Megabit,7,2011,34,97,98,229
Oromia,East Wellega,Kiremu,Meskerem,1,2011,15,56,7,78
Oromia,Nekemte Town,Nekemte Town,Hedar,3,2011,68,26,61,155
Oromia,West Shewa,Ambo Hospital,Tir,5,2009,16,46,80,142
Oromia,West Wellega,Gimbi Rural,Sene,10,2009,70,6,40,116
Oromia,North Shewa,Dera Hospital,Megabit,7,2011,8,80,86,174
Oromia,West Hararge,Mesela,Teqemt,2,2010,24,46,2,72
Oromia,Ilu Aba Bora,Bilonopa,Yekatit,6,2010,92,17,15,124
Oromia,West Arsi,Kokosa  Hospital,Miyazia,8,2011,25,25,12,62
Oromia,East Shewa,Lomme,Teqemt,2,2010,22,44,29,95
Oromia,Bale,Agarfa,Hedar,3,2010,93,11,25,129
Oromia,West Wellega,Seyo Nole,Meskerem,1,2010,99,29,58,186
Oromia,Buno Bedele,Bedele Hospital,Tir,5,2011,35,38,56,129
Oromia,North Shewa,Kuyu,Sene,10,2011,54,91,90,235
Oromia,West Arsi,Wondo,Megabit,7,2009,2,32,6,40
Oromia,West Arsi,Kore,Tahesas,4,2010,27,43,51,121
Oromia,East Wellega,Guto Gida,Teqemt,2,2011,45,90,3,138
Oromia,Finfine Zuria,Sebeta Awas,Ginbot,9,2011,92,41,17,150
Oromia,Jimma,Dedo,Megabit,7,2010,96,54,4,154
Oromia,Bale,Gololcha,Megabit,7,2009,28,23,75,126
Oromia,East Wellega,Boneya Bushe,Meskerem,1,2011,19,68,2,89
Oromia,East Hararge,Kumbi,Yekatit,6,2010,99,94,82,275
Oromia,South West Shewa,Wonchi,Nehase,12,2009,83,12,8,103
Oromia,Horo Gudru Wellega,Horro Buluk,Yekatit,6,2010,54,86,70,210
Oromia,West Wellega,Lata Sibu,Nehase,12,2009,30,5,15,50
Oromia,South West Shewa,Ilu,Miyazia,8,2011,44,75,17,136
Oromia,Borena,Yabelo Hospital,Miyazia,8,2009,63,63,0,126
Oromia,North Shewa,Debre Libanos,Megabit,7,2010,29,19,76,124
Oromia,East Hararge,Kombolicha,Tir,5,2009,7,48,78,133
Oromia,Adama Special Town,Adama Town,Yekatit,6,2010,92,77,51,220
Oromia,Borena,Moyale,Hedar,3,2011,19,20,46,85
Oromia,Arsi,Guna,Yekatit,6,2010,32,52,14,98
Oromia,North Shewa,Fichetown,Miyazia,8,2009,6,40,60,106
Oromia,Horo Gudru Wellega,Abe Dengoro,Teqemt,2,2011,45,85,86,216
Oromia,East Wellega,Nunu Qumba,Tir,5,2009,34,74,26,134
Oromia,East Hararge,Bisidimo Hospital,Megabit,7,2011,8,82,80,170
Oromia,West Shewa,Ambo,Teqemt,2,2011,65,72,84,221
Oromia,East Hararge,Haromaya Town,Hamle,11,2009,74,73,1,148
Oromia,East Shewa,Adea,Yekatit,6,2009,10,0,65,75
Oromia,West Hararge,Anchar,Megabit,7,2011,64,61,27,152
Oromia,East Wellega,Nunu Qumba,Hamle,11,2010,42,90,13,145
Oromia,East Hararge,Melka Belo,Tahesas,4,2010,35,56,1,92
Oromia,Horo Gudru Wellega,Abay Chomen,Hedar,3,2011,17,43,20,80
Oromia,West Wellega,Boji Dermeji,Miyazia,8,2011,76,65,73,214
Oromia,Qeleme Wellega,Gidami,Hedar,3,2010,90,84,17,191
Oromia,Bale,Goba,Nehase,12,2010,12,26,51,89
Oromia,West Hararge,West Harerge	Gumbi Bordede,Ginbot,9,2009,13,24,89,126
Oromia,South West Shewa,Goro,Yekatit,6,2011,66,84,64,214
Oromia,West Arsi,Gedeb Asasa,Ginbot,9,2010,17,43,41,101
Oromia,Bale,Dinsho,Hedar,3,2010,77,69,28,174
Oromia,Jimma,Kersa,Hedar,3,2010,84,64,74,222
Oromia,North Shewa,Abichugna,Miyazia,8,2009,26,26,86,138
Oromia,West Shewa,Jeldu,Hedar,3,2010,70,17,27,114
Oromia,Qeleme Wellega,Laloqile,Megabit,7,2011,57,37,94,188
Oromia,Bishoftu Town,Bishoftu Town,Miyazia,8,2011,29,13,40,82
Oromia,West Arsi,Hebal Arsi,Tir,5,2011,68,46,85,199
Oromia,Bale,Goba Town,Yekatit,6,2010,83,80,29,192
Oromia,Arsi,Sude,Miyazia,8,2011,89,88,50,227
Oromia,West Arsi,Dodola Rural,Tir,5,2010,97,77,19,193
Oromia,East Shewa,Fentale,Ginbot,9,2010,58,94,47,199
Oromia,East Wellega,Gudeyabila,Nehase,12,2009,83,66,59,208
Oromia,North Shewa,Fichetown,Yekatit,6,2011,30,95,38,163
Oromia,East Hararge,Kurfa Chele,Yekatit,6,2010,20,33,6,59
Oromia,West Wellega,Ayira Hospital,Miyazia,8,2010,45,35,27,107
Oromia,Borena,Moyale,Megabit,7,2009,9,48,7,64
Oromia,West Wellega,Guliso,Sene,10,2010,43,65,22,130
Oromia,Buno Bedele,Diga,Nehase,12,2009,67,8,74,149
Oromia,West Arsi,Gedeb Asasa,Yekatit,6,2009,15,45,44,104
Oromia,West Hararge,Anchar,Miyazia,8,2009,25,56,51,132
Oromia,Guji,Negele Hospital,Megabit,7,2010,14,2,46,62
Oromia,North Shewa,Debre Libanos,Tir,5,2011,54,38,21,113
Oromia,Jimma,Limu Kosa,Megabit,7,2009,71,99,30,200
Oromia,East Hararge,Girawa,Ginbot,9,2009,3,51,11,65
Oromia,West Guji,Abaya,Tahesas,4,2010,87,33,49,169
Oromia,West Wellega,Begi Hospital,Sene,10,2010,8,74,12,94
Oromia,Bale,Gasera,Miyazia,8,2010,50,28,92,170
Oromia,Adama Special Town,Adama Town,Nehase,12,2010,61,54,42,157
Oromia,Horo Gudru Wellega,Gudru,Sene,10,2009,13,14,24,51
Oromia,West Hararge,Chiro Zuriya,Teqemt,2,2011,70,51,56,177
Oromia,Horo Gudru Wellega,Jima Rare,Meskerem,1,2011,68,59,33,160
Oromia,East Hararge,Kurfa Chele,Megabit,7,2010,81,12,64,157
Oromia,West Shewa,Abuna Gindeberet,Nehase,12,2010,6,95,18,119
Oromia,East Wellega,Jimma Arjo,Miyazia,8,2011,9,28,73,110
Oromia,Arsi,Aseko,Nehase,12,2009,82,72,48,202
Oromia,North Shewa,Yaya Gulele,Nehase,12,2010,77,48,49,174
Oromia,Nekemte Town,Nekemte Town,Hedar,3,2011,63,40,18,121
Oromia,West Hararge,Daro Lebu,Meskerem,1,2010,49,56,38,143
Oromia,East Wellega,Wayu Tuqa,Yekatit,6,2010,66,54,88,208
Oromia,Buno Bedele,Meko,Tahesas,4,2010,25,51,88,164
Oromia,Qeleme Wellega,Dambi Dollo,Sene,10,2009,85,73,89,247
Oromia,Guji,Goro Dola,Tahesas,4,2010,47,70,65,182
Oromia,Ilu Aba Bora,Nono Sele,Hedar,3,2011,93,82,16,191
Oromia,Ilu Aba Bora,Metu Rural,Miyazia,8,2010,88,4,76,168
Oromia,Bale,Goba,Megabit,7,2010,57,84,8,149
Oromia,Arsi,Tiyo,Meskerem,1,2010,69,39,42,150
Oromia,Ilu Aba Bora,Metu Rural,Teqemt,2,2011,83,73,21,177
Oromia,West Shewa,Dano,Yekatit,6,2010,70,41,3,114
Oromia,North Shewa,Debre Libanos,Tahesas,4,2011,44,46,4,94
Oromia,Arsi,Sire,Sene,10,2009,20,72,50,142
Oromia,Borena,Dilo,Meskerem,1,2010,79,82,54,215
Oromia,Borena,Dilo,Sene,10,2010,36,28,97,161
Oromia,Jimma,Gomma,Sene,10,2011,18,81,41,140
Oromia,North Shewa,Kuyu Hospital,Nehase,12,2010,50,32,36,118
Oromia,East Hararge,Deder Hospital,Nehase,12,2010,58,40,86,184
Oromia,West Guji,Gelana,Nehase,12,2010,86,76,84,246
Oromia,East Shewa,Adami Tulu Jido Kombolcha,Ginbot,9,2010,60,32,95,187
Oromia,West Wellega,Kundala,Hedar,3,2011,39,44,25,108
Oromia,Borena,Yabelo Rural,Hamle,11,2009,50,84,89,223
Oromia,East Hararge,Haromaya Town,Hamle,11,2010,62,50,74,186
Oromia,West Hararge,Anchar,Yekatit,6,2009,66,81,35,182
Oromia,Ilu Aba Bora,Nono Sele,Hedar,3,2010,21,80,51,152
Oromia,West Hararge,Anchar,Yekatit,6,2010,60,36,66,162
Oromia,Arsi,Gololcha,Sene,10,2010,8,78,92,178
Oromia,Bale,Arena Buluq,Ginbot,9,2011,74,98,84,256
Oromia,West Arsi,Kokosa,Meskerem,1,2011,46,43,67,156
Oromia,Horo Gudru Wellega,Amuru,Tir,5,2009,40,46,10,96
Oromia,East Wellega,Sibu Sire,Hamle,11,2010,96,16,63,175
Oromia,West Wellega,Ayira Hospital,Megabit,7,2010,16,23,84,123
Oromia,Arsi,Dodota,Tir,5,2010,55,60,45,160
Oromia,West Arsi,Wondo,Tahesas,4,2010,71,77,62,210
Oromia,Jimma,Guma,Megabit,7,2010,52,14,33,99
Oromia,West Wellega,Nejo Hospital,Hamle,11,2010,30,27,10,67
Oromia,East Hararge,Gole Oda,Hamle,11,2009,93,49,39,181
Oromia,Finfine Zuria,Berreh,Tir,5,2010,22,16,78,116
Oromia,Arsi,Ludehetosa,Ginbot,9,2010,92,15,9,116
Oromia,West Hararge,Tulo,Ginbot,9,2009,30,48,30,108
Oromia,Finfine Zuria,Mullo,Miyazia,8,2009,45,13,6,64
Oromia,West Hararge,Doba,Hedar,3,2010,95,84,83,262
Oromia,Guji,Negele Town,Megabit,7,2009,84,56,30,170
Oromia,Guji,Wadara,Nehase,12,2010,21,34,21,76
Oromia,Guji,Girja,Ginbot,9,2011,17,10,60,87
Oromia,Arsi,Jeju,Tir,5,2009,82,6,32,120
Oromia,West Wellega,Babo Gembel,Hedar,3,2011,94,18,19,131
Oromia,Borena,El Way,Ginbot,9,2010,18,57,50,125
Oromia,West Shewa,Jibat,Hamle,11,2010,54,89,51,194
Oromia,South West Shewa,Ameya Hospital,Nehase,12,2010,20,15,89,124
Oromia,North Shewa,Fiche Hospital,Ginbot,9,2011,96,92,53,241
Oromia,West Hararge,Oda Bultum,Teqemt,2,2010,24,4,24,52
Oromia,Jimma,Agaro Hospital,Miyazia,8,2011,26,24,37,87
Oromia,Ilu Aba Bora,Ale,Teqemt,2,2010,10,46,45,101
Oromia,Guji,Negele Town,Tir,5,2011,8,61,1,70
Oromia,West Arsi,Gedeb Asasa,Hamle,11,2009,23,36,40,99
Oromia,Buno Bedele,Chewaqa,Hedar,3,2010,72,80,53,205
Oromia,East Shewa,Adama,Yekatit,6,2009,34,37,80,151
Oromia,West Arsi,Kore,Sene,10,2011,92,39,35,166
Oromia,East Hararge,Gole Oda,Tahesas,4,2010,34,92,19,145
Oromia,East Hararge,Gursum,Hamle,11,2009,92,90,99,281
Oromia,West Shewa,Bako Tibe,Miyazia,8,2010,45,77,58,180
Oromia,Assela Town,Assela Town,Teqemt,2,2010,97,79,78,254
Oromia,Bale,Agarfa,Teqemt,2,2011,55,38,99,192
Oromia,West Guji,Mkelka Soda,Megabit,7,2010,53,82,47,182
Oromia,Finfine Zuria,Sululta Town,Yekatit,6,2009,77,86,82,245
Oromia,Guji,Dima,Tahesas,4,2010,10,72,2,84
Oromia,West Arsi,Wondo,Ginbot,9,2009,88,34,31,153
Oromia,Jimma,Guma,Tir,5,2010,47,64,61,172
Oromia,Ilu Aba Bora,Bilonopa,Nehase,12,2009,52,55,11,118
Oromia,Borena,Meyo,Miyazia,8,2009,30,55,63,148
Oromia,West Guji,Kercha,Megabit,7,2009,42,76,97,215
Oromia,Guji,Girja,Sene,10,2009,73,20,37,130
Oromia,Jimma Spe Town,Jimma Spe Town,Tahesas,4,2011,29,31,54,114
Oromia,Bale,Gasera,Hedar,3,2011,56,66,87,209
Oromia,East Shewa,Adami Tulu Jido Kombolcha,Megabit,7,2010,16,93,73,182
Oromia,Buno Bedele,Boricha,Ginbot,9,2011,98,33,93,224
Oromia,East Shewa,Adea,Hedar,3,2010,35,81,74,190
Oromia,Jimma,Setema,Miyazia,8,2009,15,6,78,99
Oromia,Arsi,Robe,Sene,10,2010,81,0,71,152
Oromia,West Arsi,Dodola  Hospital,Hamle,11,2010,56,49,73,178
Oromia,Horo Gudru Wellega,Jima Rare,Tahesas,4,2010,10,62,4,76
Oromia,East Hararge,Bedeno,Megabit,7,2009,94,4,7,105
Oromia,East Shewa,Bora,Megabit,7,2009,79,9,37,125
Oromia,West Shewa,Liban Jawi,Ginbot,9,2011,37,68,28,133
Oromia,West Guji,Suro Barguda,Meskerem,1,2010,40,33,89,162
Oromia,West Shewa,Midakegni,Ginbot,9,2010,39,22,62,123
Oromia,East Hararge,Chelenko Hospital,Hedar,3,2011,70,15,71,156
Oromia,Guji,Adola Town,Megabit,7,2009,57,12,76,145
Oromia,North Shewa,Fichetown,Miyazia,8,2011,71,90,79,240
Oromia,Horo Gudru Wellega,Horo,Sene,10,2011,45,56,97,198
Oromia,Jimma,Limu Hospital,Hamle,11,2010,93,30,43,166
Oromia,West Hararge,Chiro Town,Sene,10,2009,44,83,3,130
Oromia,Bale,Dawe Serar,Yekatit,6,2009,88,92,81,261
Oromia,West Wellega,Begi Hospital,Teqemt,2,2010,35,16,27,78
Oromia,East Wellega,Nunu Qumba,Megabit,7,2011,4,58,72,134
Oromia,Arsi,Ludehetosa,Hamle,11,2009,79,79,21,179
Oromia,Borena,Arero,Meskerem,1,2010,31,73,34,138
Oromia,Bale,Seweyna,Hedar,3,2010,31,75,20,126
Oromia,Borena,Dubluk,Sene,10,2010,28,47,40,115
Oromia,Jimma,Mana,Hamle,11,2009,44,90,4,138
Oromia,East Wellega,Ebantu,Nehase,12,2010,23,38,41,102
Oromia,West Guji,Abaya,Hedar,3,2011,36,1,45,82
Oromia,Buno Bedele,Bedele Town,Sene,10,2009,22,62,60,144
Oromia,Bale,Goba Town,Yekatit,6,2009,90,82,97,269
Oromia,Arsi,Digeluna Tijo,Hedar,3,2010,76,12,63,151
Oromia,Adama Special Town,Adama Town,Nehase,12,2010,26,32,78,136
Oromia,East Hararge,Meta,Miyazia,8,2011,9,99,29,137
Oromia,Jimma,Limu Kosa,Meskerem,1,2011,55,26,61,142
Oromia,East Wellega,Gobu Seyo,Hedar,3,2011,38,69,94,201
Oromia,West Wellega,Homa,Hamle,11,2009,2,68,5,75
Oromia,Qeleme Wellega,Dale Sedi,Yekatit,6,2009,55,91,4,150
Oromia,Qeleme Wellega,Dale Wabera,Hamle,11,2010,35,89,59,183
Oromia,East Wellega,Sibu Sire,Tir,5,2009,5,51,72,128
Oromia,East Shewa,Boset,Hamle,11,2010,53,53,13,119
Oromia,Bale,Goba,Hedar,3,2011,34,95,46,175
Oromia,Arsi,Deksis,Hamle,11,2009,54,53,12,119
Oromia,South West Shewa,Becho,Nehase,12,2010,68,0,35,103
Oromia,East Wellega,Boneya Bushe,Meskerem,1,2011,10,94,24,128
Oromia,Bale,Gololcha,Nehase,12,2009,17,78,16,111
Oromia,West Guji,Abaya,Meskerem,1,2011,13,17,24,54
Oromia,North Shewa,Yaya Gulele,Sene,10,2010,3,33,32,68
Oromia,Arsi,Zeway Dugda,Sene,10,2009,47,78,23,148
Oromia,West Shewa,Abuna Gindeberet,Ginbot,9,2009,26,33,13,72
Oromia,West Guji,Bule Hora Hospital,Hedar,3,2011,77,71,4,152
Oromia,East Hararge,Kurfa Chele,Nehase,12,2010,8,10,15,33
Oromia,Borena,Guchi,Sene,10,2010,83,9,21,113
Oromia,Bale,Sinana,Nehase,12,2010,45,9,69,123
Oromia,East Wellega,Sibu Sire,Megabit,7,2009,50,71,44,165
Oromia,East Hararge,Midega Tole,Yekatit,6,2010,81,34,24,139
Oromia,East Shewa,Bora,Ginbot,9,2010,41,50,95,186
Oromia,East Wellega,Kiremu,Miyazia,8,2010,56,26,78,160
Oromia,Qeleme Wellega,Kake Hosp,Megabit,7,2011,9,51,12,72
Oromia,East Hararge,Babile Woreda,Ginbot,9,2009,39,32,59,130
Oromia,West Arsi,Bishan Guracha Town,Tahesas,4,2010,2,17,62,81
Oromia,Ilu Aba Bora,Metu Rural,Ginbot,9,2009,93,17,66,176
Oromia,West Guji,Suro Barguda,Ginbot,9,2009,72,26,15,113
Oromia,Bale,Dinsho,Ginbot,9,2011,49,47,99,195
Oromia,East Hararge,Midega Tole,Sene,10,2010,63,3,7,73
Oromia,West Arsi,Siraro,Hamle,11,2010,65,71,82,218
Oromia,Arsi,Dodota,Nehase,12,2010,58,73,79,210
Oromia,West Shewa,Dendi,Yekatit,6,2011,51,15,40,106
Oromia,West Shewa,Jeldu,Teqemt,2,2010,14,65,92,171
Oromia,East Shewa,Bora,Hamle,11,2009,14,85,75,174
Oromia,Qeleme Wellega,Yemalogi Wolel,Megabit,7,2009,1,82,15,98
Oromia,West Hararge,Burka Dimtu,Teqemt,2,2010,52,91,28,171
Oromia,Assela Town,Assela Town,Tahesas,4,2010,48,9,37,94
Oromia,West Arsi,Loke Hada Hospital,Teqemt,2,2011,65,66,67,198
Oromia,East Shewa,Fentale,Miyazia,8,2011,86,25,7,118
Oromia,Jimma,Dedo,Hedar,3,2010,58,28,41,127
Oromia,West Hararge,Burka Dimtu,Sene,10,2009,50,12,7,69
Oromia,West Shewa,Inchini Hospital,Megabit,7,2011,23,94,74,191
Oromia,West Hararge,Anchar,Tahesas,4,2010,10,12,76,98
Oromia,East Hararge,Kombolicha,Meskerem,1,2011,18,54,76,148
Oromia,South West Shewa,Becho,Megabit,7,2011,3,95,74,172
Oromia,West Wellega,Gimbi Adventist Hospital,Miyazia,8,2010,42,56,45,143
Oromia,West Shewa,Abuna Gindeberet,Megabit,7,2011,35,58,58,151
Oromia,East Wellega,Nunu Qumba,Tahesas,4,2011,83,64,92,239
Oromia,Arsi,Seru,Hamle,11,2010,43,82,10,135
Oromia,West Shewa,Inchini Hospital,Ginbot,9,2011,31,78,8,117
Oromia,Jimma,Tiro Afeta,Hamle,11,2009,64,11,94,169
Oromia,West Guji,Bule Hora Toun,Miyazia,8,2011,85,81,66,232
Oromia,Borena,El Way,Hedar,3,2010,34,33,97,164
Oromia,West Shewa,Bako Tibe,Ginbot,9,2011,28,99,11,138
Oromia,Jimma,Chora Boter,Megabit,7,2011,3,46,81,130
Oromia,West Hararge,Gelemso Hospital,Meskerem,1,2011,27,93,24,144
Oromia,East Hararge,Deder Town,Yekatit,6,2010,40,83,23,146
Oromia,Borena,Guchi,Miyazia,8,2010,85,4,59,148
Oromia,Buno Bedele,Dedesa,Megabit,7,2009,66,66,17,149
Oromia,East Hararge,Deder Town,Tahesas,4,2010,6,46,24,76
Oromia,North Shewa,Fichetown,Yekatit,6,2009,93,21,7,121
Oromia,Ilu Aba Bora,Metu Rural,Nehase,12,2010,25,38,15,78
Oromia,Borena,Moyale Hospital,Hedar,3,2011,16,4,36,56
Oromia,Arsi,Guna,Hamle,11,2010,8,53,33,94
Oromia,Guji,Aga Wayyu,Sene,10,2010,40,73,89,202
Oromia,Buno Bedele,Chora,Megabit,7,2010,90,47,51,188
Oromia,Ilu Aba Bora,Bure,Ginbot,9,2011,14,79,66,159
Oromia,North Shewa,Degem,Miyazia,8,2011,14,54,92,160
Oromia,Jimma,Sekoru,Ginbot,9,2010,91,87,51,229
Oromia,West Wellega,Gimbi Rural,Tir,5,2010,71,44,18,133
Oromia,West Hararge,Bedesa Town,Nehase,12,2010,96,25,50,171
Oromia,West Arsi,Dodola Town,Megabit,7,2011,99,75,52,226
Oromia,West Shewa,Abuna Gindeberet,Tir,5,2010,58,95,36,189
Oromia,West Arsi,Adaba,Ginbot,9,2009,73,45,46,164
Oromia,West Guji,Bule Hora Toun,Miyazia,8,2009,9,91,10,110
Oromia,Jimma,Seka Chekorsa,Meskerem,1,2011,4,88,19,111
Oromia,West Hararge,West Harerge	Gumbi Bordede,Miyazia,8,2009,29,89,92,210
Oromia,Ilu Aba Bora,Becho,Meskerem,1,2010,88,87,70,245
Oromia,West Wellega,Gimbi Adventist Hospital,Miyazia,8,2011,39,7,18,64
Oromia,West Wellega,Mendi Town,Hamle,11,2009,10,27,35,72
Oromia,East Hararge,Midega Tole,Yekatit,6,2009,83,46,85,214
Oromia,East Shewa,Lomme,Meskerem,1,2011,27,50,14,91
Oromia,South West Shewa,Tole,Tahesas,4,2010,82,82,44,208
Oromia,Horo Gudru Wellega,Horo,Tir,5,2009,9,72,13,94
Oromia,Jimma,Dedo,Hamle,11,2009,52,44,21,117
Oromia,Guji,Saba Boru,Tir,5,2011,96,2,92,190
Oromia,West Shewa,Elifata,Hedar,3,2010,0,39,40,79
Oromia,West Arsi,Kokosa,Megabit,7,2011,90,45,32,167
Oromia,Finfine Zuria,Sululta Town,Megabit,7,2010,64,55,31,150
Oromia,West Arsi,Shala,Tir,5,2010,79,35,83,197
Oromia,West Wellega,Babo Gembel,Megabit,7,2011,53,18,32,103
Oromia,West Wellega,Babo Gembel,Tir,5,2010,5,82,73,160
Oromia,West Arsi,Nensebo,Tir,5,2010,29,10,35,74
Oromia,East Hararge,Meyu Muleke,Megabit,7,2009,33,11,58,102
Oromia,Finfine Zuria,Sandefa,Ginbot,9,2009,14,5,89,108
Oromia,West Hararge,Daro Lebu,Nehase,12,2010,53,36,56,145
Oromia,East Hararge,Goro Gutu,Teqemt,2,2010,85,87,14,186
Oromia,Buno Bedele,Boricha,Ginbot,9,2009,6,87,90,183
Oromia,West Shewa,Tikur Enchini,Ginbot,9,2009,27,7,34,68
Oromia,West Guji,Kercha Hospital,Ginbot,9,2009,17,35,50,102
Oromia,East Shewa,Adama,Sene,10,2010,91,20,43,154
Oromia,Jimma,Sekoru,Tir,5,2010,4,73,6,83
Oromia,West Arsi,Kokosa,Megabit,7,2010,95,92,41,228
Oromia,Qeleme Wellega,Jimma Horo,Meskerem,1,2011,92,20,43,155
Oromia,Arsi,Hitosa,Tahesas,4,2011,45,29,81,155
Oromia,East Wellega,Guto Gida,Teqemt,2,2011,36,92,71,199
Oromia,Horo Gudru Wellega,Shambu Town,Hamle,11,2009,84,8,97,189
Oromia,Guji,Anna Sora,Tir,5,2009,29,28,65,122
Oromia,Arsi,Amigna,Sene,10,2010,15,89,12,116
Oromia,West Guji,Gelana,Tir,5,2011,14,93,7,114
Oromia,South West Shewa,St.Luke Hospital,Nehase,12,2010,52,86,11,149
Oromia,West Wellega,Gimbi Adventist Hospital,Meskerem,1,2011,30,72,45,147
Oromia,Jimma,Mana,Tir,5,2011,26,49,33,108
Oromia,West Wellega,Boji Cheqorsa,Teqemt,2,2011,28,61,88,177
Oromia,Buno Bedele,Bedele Town,Yekatit,6,2010,30,92,23,145
Oromia,North Shewa,Kuyu Hospital,Miyazia,8,2010,11,42,23,76
Oromia,East Shewa,Mojo,Yekatit,6,2009,45,65,65,175
Oromia,Finfine Zuria,Sebeta Awas,Miyazia,8,2011,19,27,87,133
Oromia,West Shewa,Gojo Hospital,Tir,5,2010,26,48,12,86
Oromia,Nekemte Town,Nekemte Town,Hedar,3,2010,6,2,43,51
Oromia,West Arsi,Kore,Sene,10,2009,17,75,94,186
Oromia,West Wellega,Gimbi Adventist Hospital,Miyazia,8,2011,32,10,66,108
Oromia,Horo Gudru Wellega,Shambu Hospital,Sene,10,2010,93,53,98,244
Oromia,North Shewa,Kuyu Hospital,Yekatit,6,2009,48,11,62,121
Oromia,West Hararge,Guba Qoricha,Nehase,12,2009,92,22,11,125
Oromia,West Guji,Mkelka Soda,Teqemt,2,2010,22,2,27,51
Oromia,Arsi,Tena,Hamle,11,2010,49,52,22,123
Oromia,East Shewa,Liben,Tir,5,2009,31,51,4,86
Oromia,Buno Bedele,Boricha,Megabit,7,2009,66,76,48,190
Oromia,West Arsi,Kore,Hamle,11,2009,47,29,6,82
Oromia,West Wellega,Mene Sibu,Miyazia,8,2009,74,54,75,203
Oromia,East Wellega,Sasiga,Megabit,7,2011,18,90,23,131
Oromia,Bale,Legehida,Meskerem,1,2010,11,90,58,159
Oromia,West Hararge,Chiro Zuriya,Hamle,11,2010,27,42,43,112
Oromia,Jimma,Omo Nada Hospital,Hamle,11,2010,40,87,46,173
Oromia,Buno Bedele,Chora,Tahesas,4,2010,48,7,15,70
Oromia,Holeta Town,Holeta Town,Teqemt,2,2011,25,68,34,127
Oromia,Buno Bedele,Dedesa,Tir,5,2009,13,74,83,170
Oromia,Buno Bedele,Meko,Teqemt,2,2011,88,94,47,229
Oromia,East Wellega,Ebantu,Ginbot,9,2010,45,17,75,137
Oromia,Guji,Hambela Wamena,Hedar,3,2010,19,8,86,113
Oromia,Borena,Dubluk,Meskerem,1,2011,65,44,76,185
Oromia,East Wellega,Sasiga,Hedar,3,2010,3,15,43,61
Oromia,Arsi,Enkelo Wabe,Teqemt,2,2011,53,43,52,148
Oromia,West Shewa,Bako Tibe,Teqemt,2,2010,52,56,50,158
Oromia,West Shewa,Ilu Galan,Nehase,12,2010,17,2,81,100
Oromia,Bale,Agarfa,Miyazia,8,2009,27,39,16,82
Oromia,Buno Bedele,Bedele Town,Tir,5,2011,55,39,43,137
Oromia,East Hararge,Fedis,Teqemt,2,2011,81,77,14,172
Oromia,West Hararge,Habro,Miyazia,8,2011,95,75,80,250
Oromia,West Wellega,Kundala,Megabit,7,2009,15,54,50,119
Oromia,West Shewa,Abuna Gindeberet,Sene,10,2011,45,48,36,129
Oromia,West Wellega,Guliso,Hedar,3,2010,81,63,56,200
Oromia,Ilu Aba Bora,Hurumu,Miyazia,8,2010,21,72,51,144
Oromia,Jimma,Tiro Afeta,Tir,5,2010,72,40,7,119
Oromia,Arsi,Amigna,Hamle,11,2009,27,46,66,139
Oromia,West Wellega,Jarso,Tir,5,2010,3,90,90,183
Oromia,West Guji,Dugda Dawa,Tahesas,4,2010,22,85,80,187
Oromia,Buno Bedele,Chewaqa,Miyazia,8,2009,34,90,31,155
Oromia,Finfine Zuria,Sebeta Awas,Hedar,3,2010,13,79,22,114
Oromia,East Hararge,Meta,Megabit,7,2009,77,50,96,223
Oromia,Ilu Aba Bora,Ale,Tir,5,2009,88,80,7,175
Oromia,Bale,Seweyna,Tir,5,2010,29,48,7,84
Oromia,Arsi,Tena,Teqemt,2,2011,40,12,64,116
Oromia,North Shewa,Hidabu Abote,Ginbot,9,2011,6,40,67,113
Oromia,East Wellega,Gudeyabila,Meskerem,1,2011,13,52,56,121
Oromia,Burayu Town,Burayu Town,Tir,5,2010,80,34,77,191
Oromia,Jimma,Guma,Megabit,7,2009,45,20,48,113
Oromia,East Hararge,Meta,Megabit,7,2010,66,82,86,234
Oromia,West Wellega,Nejo Rural,Megabit,7,2011,34,54,38,126
Oromia,West Guji,Bule Hora Hospital,Ginbot,9,2011,50,68,93,211
Oromia,Qeleme Wellega,Dambi Dolo Hospital,Yekatit,6,2010,27,94,64,185
Oromia,East Hararge,Kurfa Chele,Megabit,7,2009,37,20,59,116
Oromia,East Wellega,Kiremu,Megabit,7,2011,67,65,31,163
Oromia,West Arsi,Kore,Ginbot,9,2009,16,20,90,126
Oromia,Ilu Aba Bora,Didu,Megabit,7,2009,83,1,50,134
Oromia,Qeleme Wellega,Seyo,Sene,10,2010,78,26,1,105
Oromia,West Arsi,Hebal Arsi,Yekatit,6,2011,82,88,19,189
Oromia,Finfine Zuria,Sandefa,Yekatit,6,2009,46,17,81,144
Oromia,East Shewa,Matahara,Ginbot,9,2010,99,46,3,148
Oromia,Buno Bedele,Bedele Town,Nehase,12,2009,93,72,86,251
Oromia,Bale,Arena Buluq,Megabit,7,2010,20,52,81,153
Oromia,West Arsi,Arsi Negele Town,Hamle,11,2009,40,88,80,208
Oromia,East Wellega,Nunu Qumba,Megabit,7,2011,57,90,88,235
Oromia,Guji,Negele Town,Nehase,12,2010,52,43,70,165
Oromia,West Shewa,Jeldu,Yekatit,6,2010,91,87,87,265
Oromia,West Hararge,Bedesa Town,Sene,10,2009,97,57,45,199
Oromia,Bale,Sinana,Miyazia,8,2010,50,32,19,101
Oromia,Ilu Aba Bora,Becho,Tir,5,2011,63,47,3,113
Oromia,Jimma,Seka Chekorsa,Ginbot,9,2011,61,90,28,179
Oromia,Borena,Dire,Yekatit,6,2011,67,67,27,161
Oromia,Arsi,Sude,Hedar,3,2010,87,36,40,163
Oromia,West Shewa,Dendi,Tir,5,2009,39,61,53,153
Oromia,West Guji,Abaya,Hedar,3,2011,22,88,40,150
Oromia,South West Shewa,Ilu,Tir,5,2010,99,8,71,178
Oromia,Finfine Zuria,Sululta Town,Megabit,7,2010,79,75,80,234
Oromia,South West Shewa,Bantu  Hospital,Megabit,7,2011,0,73,78,151
Oromia,East Shewa,Fentale,Ginbot,9,2009,95,34,5,134
Oromia,West Shewa,Chelia,Yekatit,6,2010,6,56,69,131
Oromia,Arsi,Munesa,Ginbot,9,2011,14,61,33,108
Oromia,East Shewa,Gimbichu,Sene,10,2009,3,58,79,140
Oromia,North Shewa,Dera,Teqemt,2,2010,58,10,47,115
Oromia,East Hararge,Babile,Miyazia,8,2009,35,85,15,135
Oromia,Guji,Girja,Meskerem,1,2011,86,68,81,235
Oromia,Jimma,Gomma,Yekatit,6,2011,57,82,83,222
Oromia,East Shewa,Dugda,Hedar,3,2011,59,24,40,123
Oromia,South West Shewa,Becho,Yekatit,6,2010,89,43,34,166
Oromia,West Arsi,Shashemene Rural,Megabit,7,2011,0,36,42,78
Oromia,East Wellega,Kiremu,Ginbot,9,2009,59,11,74,144
Oromia,North Shewa,Debre Libanos,Teqemt,2,2010,16,3,61,80
Oromia,West Arsi,Kore,Tir,5,2011,4,7,5,16
Oromia,Horo Gudru Wellega,Amuru,Hamle,11,2010,27,68,92,187
Oromia,East Wellega,Wayu Tuqa,Teqemt,2,2010,36,84,94,214
Oromia,West Shewa,Guder Hosp,Ginbot,9,2010,34,93,34,161
Oromia,West Wellega,Boji Dermeji,Megabit,7,2009,29,29,52,110
Oromia,Ilu Aba Bora,Hurumu,Yekatit,6,2011,80,5,12,97
Oromia,Arsi,Digeluna Tijo,Sene,10,2009,91,49,39,179
Oromia,East Hararge,Bisidimo Hospital,Ginbot,9,2010,4,59,62,125
Oromia,Woliso Town,Woliso Town,Yekatit,6,2011,91,86,29,206
Oromia,South West Shewa,Wonchi,Nehase,12,2009,61,68,88,217
Oromia,West Wellega,Lalo Asabi,Nehase,12,2009,11,75,18,104
Oromia,Arsi,Dodota,Megabit,7,2010,46,0,81,127
Oromia,East Hararge,Gole Oda,Hedar,3,2010,39,84,34,157
Oromia,West Arsi,Kokosa,Nehase,12,2010,68,69,32,169
Oromia,West Shewa,Tikur Enchini,Miyazia,8,2011,6,22,85,113
Oromia,West Arsi,Adaba,Sene,10,2010,93,26,1,120
Oromia,Jimma,Dedo,Nehase,12,2010,29,35,86,150
Oromia,Horo Gudru Wellega,Gudru,Hedar,3,2010,32,2,48,82
Oromia,Guji,Dima,Tir,5,2011,3,95,75,173
Oromia,West Wellega,Nejo Rural,Meskerem,1,2011,9,81,77,167
Oromia,West Wellega,Homa,Ginbot,9,2010,54,55,44,153
Oromia,North Shewa,Abichugna,Meskerem,1,2010,86,14,58,158
Oromia,West Hararge,Daro Lebu,Sene,10,2009,74,11,32,117
Oromia,East Hararge,Kurfa Chele,Megabit,7,2010,71,20,21,112
Oromia,North Shewa,Abichugna,Tir,5,2011,94,94,64,252
Oromia,Guji,Shakiso Town,Megabit,7,2010,50,5,99,154
Oromia,Arsi,Amigna,Tahesas,4,2010,67,23,56,146
Oromia,Bale,Gasera,Megabit,7,2009,97,95,38,230
Oromia,Jimma,Shabe,Meskerem,1,2010,62,60,17,139
Oromia,Guji,Aga Wayyu,Tir,5,2011,15,21,79,115
Oromia,East Hararge,Bedeno,Hamle,11,2010,50,11,14,75
Oromia,Qeleme Wellega,Dale Wabera,Miyazia,8,2009,82,64,69,215
Oromia,Borena,Yabelo Hospital,Sene,10,2009,47,73,15,135
Oromia,North Shewa,Aleiltu,Yekatit,6,2010,48,36,32,116
Oromia,West Hararge,Chiro Town,Miyazia,8,2010,33,7,15,55
Oromia,West Wellega,Lalo Asabi,Hedar,3,2011,53,53,13,119
Oromia,Buno Bedele,Diga,Megabit,7,2009,87,22,10,119
Oromia,West Hararge,Boke,Nehase,12,2009,60,2,98,160
Oromia,North Shewa,Abichugna,Tahesas,4,2011,83,44,11,138
Oromia,Arsi,Bekoji Town,Sene,10,2009,5,12,70,87
Oromia,Borena,Dilo,Tir,5,2011,12,89,37,138
Oromia,West Hararge,Meiso,Megabit,7,2010,29,62,52,143
Oromia,North Shewa,Dera Hospital,Yekatit,6,2009,88,54,95,237
Oromia,East Shewa,Batu,Yekatit,6,2010,3,83,48,134
Oromia,Qeleme Wellega,Hawa Gelan,Sene,10,2010,67,75,66,208
Oromia,Woliso Town,Woliso Town,Hedar,3,2011,83,51,51,185
Oromia,West Hararge,West Harerge	Gumbi Bordede,Tir,5,2011,26,53,2,81
Oromia,East Shewa,Dugda,Teqemt,2,2011,34,47,7,88
Oromia,East Hararge,Goro Muti,Nehase,12,2009,46,14,41,101
Oromia,Horo Gudru Wellega,Horro Buluk,Tir,5,2011,84,23,94,201
Oromia,North Shewa,Abichugna,Hamle,11,2009,37,50,75,162
Oromia,Jimma,B/Tolyi,Ginbot,9,2009,11,90,21,122
Oromia,Ilu Aba Bora,Hurumu,Ginbot,9,2009,43,59,99,201
Oromia,East Wellega,Gudeyabila,Miyazia,8,2009,60,14,17,91
Oromia,Ilu Aba Bora,Becho,Yekatit,6,2010,69,47,11,127
Oromia,West Arsi,Bishan Guracha Town,Tahesas,4,2010,67,55,88,210
Oromia,Arsi,Shenan Kolu,Sene,10,2011,56,42,80,178
Oromia,Finfine Zuria,Mullo,Hedar,3,2011,3,42,83,128
Oromia,West Guji,Hanbala,Yekatit,6,2010,87,20,26,133
Oromia,West Guji,Suro Barguda,Meskerem,1,2011,18,3,38,59
Oromia,East Shewa,Lomme,Sene,10,2011,14,89,64,167
Oromia,West Wellega,Nejo Hospital,Ginbot,9,2010,67,75,72,214
Oromia,Horo Gudru Wellega,Abay Chomen,Sene,10,2010,96,82,45,223
Oromia,West Shewa,Ejersa Lafo,Miyazia,8,2009,56,14,19,89
Oromia,East Wellega,Kiremu,Sene,10,2011,3,45,8,56
Oromia,West Hararge,Hawi Gudina,Teqemt,2,2011,98,29,52,179
Oromia,Jimma,Guma,Tir,5,2011,30,1,97,128
Oromia,Bale,Goro,Megabit,7,2011,98,11,1,110
Oromia,West Shewa,Meta Waliqite,Teqemt,2,2011,65,46,11,122
Oromia,North Shewa,Were Jarso,Miyazia,8,2010,27,35,96,158
Oromia,North Shewa,Wuchale,Megabit,7,2011,44,96,40,180
Oromia,Bale,Dawe Qachen,Nehase,12,2009,37,41,45,123
Oromia,West Wellega,Gimbi Public  Hospital,Ginbot,9,2009,0,8,65,73
Oromia,West Shewa,Jeldu,Ginbot,9,2009,72,45,79,196
Oromia,East Wellega,Nunu Qumba,Sene,10,2010,17,0,85,102
Oromia,Borena,Arero,Tir,5,2010,83,34,25,142
Oromia,Borena,Meyo,Miyazia,8,2011,90,46,80,216
Oromia,Qeleme Wellega,Dale Wabera,Sene,10,2010,79,61,45,185
Oromia,Horo Gudru Wellega,Jima Geneti,Yekatit,6,2009,16,98,58,172
Oromia,West Shewa,Guder Hosp,Tir,5,2011,39,11,87,137
Oromia,West Arsi,Dodola  Hospital,Megabit,7,2010,13,61,14,88
Oromia,Arsi,Deksis,Teqemt,2,2011,96,75,44,215
Oromia,West Wellega,Mene Sibu,Meskerem,1,2011,81,96,63,240
Oromia,Adama Special Town,Adama Town,Miyazia,8,2010,40,37,99,176
Oromia,Qeleme Wellega,Jimma Horo,Teqemt,2,2011,88,56,12,156
Oromia,East Hararge,Deder,Ginbot,9,2011,14,55,68,137
Oromia,West Guji,Hanbala,Megabit,7,2011,48,78,55,181
Oromia,Finfine Zuria,Mullo,Sene,10,2011,40,57,96,193
Oromia,West Wellega,Guliso,Hamle,11,2009,98,97,39,234
Oromia,East Hararge,Haromaya Town,Megabit,7,2010,62,6,11,79
Oromia,South West Shewa,Ameya Hospital,Teqemt,2,2011,84,10,39,133
Oromia,Ilu Aba Bora,Ale,Tahesas,4,2011,54,65,84,203
Oromia,Borena,Gomole,Teqemt,2,2011,91,10,83,184
Oromia,Horo Gudru Wellega,Jima Rare,Tahesas,4,2011,70,13,89,172
Oromia,Jimma,Omonada,Sene,10,2009,67,67,44,178
Oromia,West Arsi,Gambo Hospital,Teqemt,2,2011,43,95,51,189
Oromia,East Wellega,Guto Gida,Yekatit,6,2010,27,40,74,141
Oromia,East Hararge,Fedis,Yekatit,6,2010,8,44,3,55
Oromia,Borena,Dhas,Nehase,12,2010,51,69,91,211
Oromia,Jimma,Limu Seka,Nehase,12,2010,30,55,66,151
Oromia,Gelan Town,Gelan Town,Miyazia,8,2011,3,67,17,87
Oromia,Borena,Dilo,Nehase,12,2009,47,51,34,132
Oromia,East Hararge,Haromaya Rural,Megabit,7,2010,92,10,53,155
Oromia,Jimma,Kersa,Sene,10,2011,41,20,25,86
Oromia,Buno Bedele,Chewaqa,Tir,5,2010,62,98,31,191
Oromia,Assela Town,Assela Town,Sene,10,2010,18,96,60,174
Oromia,West Wellega,Guliso,Hedar,3,2011,36,41,57,134
Oromia,North Shewa,Jido,Ginbot,9,2009,39,16,79,134
Oromia,West Hararge,Meiso,Nehase,12,2009,47,18,81,146
Oromia,West Hararge,Meiso,Miyazia,8,2009,74,90,95,259
Oromia,East Shewa,Dugda,Yekatit,6,2010,69,16,82,167
Oromia,Jimma,Limu Kosa,Sene,10,2010,65,2,27,94
Oromia,Ilu Aba Bora,Yayu,Megabit,7,2010,48,18,71,137
Oromia,Arsi,Chole,Tahesas,4,2010,66,11,44,121
Oromia,West Wellega,Yubdo,Meskerem,1,2010,8,82,31,121
Oromia,Guji,Adola Reda,Tir,5,2009,49,45,87,181
Oromia,East Wellega,Gida Ayana,Hedar,3,2010,65,49,61,175
Oromia,Guji,Adola Town,Miyazia,8,2009,40,3,0,43
Oromia,West Arsi,Arsi Negele Town,Sene,10,2011,3,67,86,156
Oromia,West Arsi,Nensebo,Megabit,7,2011,35,61,25,121
Oromia,Guji,Adola Town,Megabit,7,2009,84,11,66,161
Oromia,East Hararge,Babile,Ginbot,9,2010,62,21,49,132
Oromia,East Wellega,Boneya Bushe,Megabit,7,2010,55,33,36,124
Oromia,West Wellega,Nole Kaba,Hamle,11,2009,32,83,17,132
Oromia,Ilu Aba Bora,Hurumu,Hamle,11,2010,31,53,24,108
Oromia,South West Shewa,Seden Sodo,Miyazia,8,2010,59,97,25,181
Oromia,East Shewa,Batu,Megabit,7,2010,75,15,60,150
Oromia,North Shewa,Girar Jarso,Meskerem,1,2010,79,91,66,236
Oromia,East Hararge,Kersa Eh,Meskerem,1,2011,75,28,60,163
Oromia,West Wellega,Begi,Ginbot,9,2009,71,21,23,115
Oromia,West Guji,Hanbala,Tir,5,2011,90,27,85,202
Oromia,South West Shewa,Dawo,Ginbot,9,2009,59,59,15,133
Oromia,Guji,Shakiso Town,Hamle,11,2009,21,40,24,85
Oromia,West Hararge,Gelemso Hospital,Ginbot,9,2011,84,52,29,165
Oromia,Jimma,O/Beyam,Tahesas,4,2011,38,32,39,109
Oromia,East Hararge,Haromaya Rural,Megabit,7,2010,82,18,5,105
Oromia,Arsi,Enkelo Wabe,Hamle,11,2010,45,87,61,193
Oromia,East Wellega,Wayu Tuqa,Hedar,3,2010,29,61,23,113
Oromia,South West Shewa,Ameya Hospital,Tir,5,2011,35,87,13,135
Oromia,West Shewa,Ejersa Lafo,Teqemt,2,2010,62,54,69,185
Oromia,West Hararge,Tulo,Hedar,3,2011,13,11,89,113
Oromia,Jimma,Kersa,Miyazia,8,2011,39,92,72,203
Oromia,West Wellega,Lata Sibu,Tir,5,2010,8,61,5,74
Oromia,North Shewa,Abichugna,Ginbot,9,2009,92,68,43,203
Oromia,East Hararge,Kombolicha,Megabit,7,2010,46,73,22,141
Oromia,Borena,Gomole,Yekatit,6,2010,98,24,36,158
Oromia,East Hararge,Babile,Ginbot,9,2011,57,24,73,154
Oromia,West Arsi,Wondo,Ginbot,9,2010,39,10,6,55
Oromia,Qeleme Wellega,Dambi Dollo,Ginbot,9,2010,79,95,86,260
Oromia,Jimma,Dedo,Miyazia,8,2010,64,52,88,204
Oromia,East Hararge,Goro Muti,Tir,5,2010,63,81,16,160
Oromia,West Wellega,Nejo Hospital,Meskerem,1,2011,64,44,88,196
Oromia,East Hararge,Deder Hospital,Tahesas,4,2011,4,49,94,147
Oromia,North Shewa,Dera,Yekatit,6,2011,97,11,62,170
Oromia,West Shewa,Ambo Town,Nehase,12,2009,69,77,75,221
Oromia,East Shewa,Batu,Nehase,12,2010,25,94,79,198
Oromia,Jimma,Gera,Hedar,3,2010,42,59,49,150
Oromia,East Wellega,Gobu Seyo,Tir,5,2011,52,77,95,224
Oromia,West Wellega,Yubdo,Meskerem,1,2010,17,5,87,109
Oromia,West Shewa,Ambo Hospital,Hamle,11,2009,81,99,76,256
Oromia,Jimma,Limu Seka,Ginbot,9,2010,10,66,36,112
Oromia,Borena,Guchi,Megabit,7,2011,56,84,24,164
Oromia,Qeleme Wellega,Jimma Horo,Miyazia,8,2011,39,74,92,205
Oromia,Bale,Ginir,Hamle,11,2010,65,3,63,131
Oromia,Qeleme Wellega,Seyo,Yekatit,6,2010,73,31,86,190
Oromia,East Shewa,Adami Tulu Jido Kombolcha,Tahesas,4,2011,78,84,30,192
Oromia,West Hararge,Anchar,Ginbot,9,2010,59,30,29,118
Oromia,Buno Bedele,Chora,Hedar,3,2010,5,17,44,66
Oromia,North Shewa,Debre Libanos,Tahesas,4,2011,37,18,5,60
Oromia,Arsi,Tena,Sene,10,2010,16,47,33,96
Oromia,West Guji,Bule Hora Hospital,Hedar,3,2010,77,63,4,144
Oromia,East Shewa,Matahara,Sene,10,2010,8,96,86,190
Oromia,Borena,Dubluk,Yekatit,6,2009,53,71,59,183
Oromia,East Wellega,Ebantu,Tahesas,4,2010,92,59,24,175
Oromia,Jimma,Chora Boter,Hamle,11,2009,74,97,36,207
Oromia,Guji,Hambela Wamena,Teqemt,2,2011,3,77,78,158
Oromia,Ilu Aba Bora,Ale,Tir,5,2011,54,95,20,169
Oromia,East Hararge,Jarso,Teqemt,2,2010,27,13,8,48
Oromia,Borena,Moyale Hospital,Hedar,3,2011,76,87,3,166
Oromia,South West Shewa,Ameya,Tir,5,2009,9,51,24,84
Oromia,West Guji,Suro Barguda,Miyazia,8,2011,19,33,51,103
Oromia,Horo Gudru Wellega,Jarte Jardga,Yekatit,6,2010,37,91,48,176
Oromia,Borena,Dhas,Nehase,12,2009,95,79,21,195
Oromia,Ilu Aba Bora,Metu Town,Miyazia,8,2010,23,7,61,91
Oromia,East Shewa,Lomme,Meskerem,1,2011,83,75,5,163
Oromia,West Shewa,Abuna Gindeberet,Ginbot,9,2010,70,56,98,224
Oromia,West Wellega,Mendi Town,Hamle,11,2010,10,63,5,78
Oromia,Bale,Arena Buluq,Megabit,7,2011,46,57,1,104
Oromia,South West Shewa,Woliso Town,Megabit,7,2009,95,19,89,203
Oromia,West Wellega,Genji,Tir,5,2009,75,16,40,131
Oromia,West Wellega,Gimbi,Hedar,3,2011,97,99,7,203
Oromia,West Shewa,Elifata,Megabit,7,2010,60,12,4,76
Oromia,East Wellega,Limu,Hamle,11,2009,51,45,75,171
Oromia,South West Shewa,Kersana Malima,Megabit,7,2010,85,32,84,201
Oromia,Bale,Goba Town,Hedar,3,2011,22,90,44,156
Oromia,Guji,Gumi Eldallo,Megabit,7,2011,97,75,84,256
Oromia,Qeleme Wellega,Sedan Chanka,Yekatit,6,2010,81,64,3,148
Oromia,West Hararge,Anchar,Tahesas,4,2010,94,31,21,146
Oromia,West Wellega,Nejo Hospital,Miyazia,8,2010,16,59,71,146
Oromia,Arsi,Limuna Bilbilo,Tahesas,4,2010,4,8,56,68
Oromia,Guji,Shakiso Town,Tahesas,4,2010,51,38,47,136
Oromia,West Shewa,Ambo,Miyazia,8,2009,70,89,77,236
Oromia,Buno Bedele,Chewaqa,Teqemt,2,2010,0,12,14,26
Oromia,South West Shewa,St.Luke Hospital,Nehase,12,2010,6,2,27,35
Oromia,Arsi,Enkelo Wabe,Megabit,7,2009,15,96,16,127
Oromia,East Hararge,Goro Gutu,Hedar,3,2011,96,47,92,235
Oromia,Arsi,Chole,Nehase,12,2010,51,17,33,101
Oromia,East Hararge,Fedis,Ginbot,9,2009,71,84,74,229
Oromia,Bishoftu Town,Bishoftu Town,Nehase,12,2009,74,70,25,169
Oromia,Ambo Town,Ambo Town,Megabit,7,2011,75,18,20,113
Oromia,West Wellega,Nole Kaba,Sene,10,2010,57,22,65,144
Oromia,South West Shewa,Tulu Bolo Hospital,Teqemt,2,2011,4,99,46,149
Oromia,West Arsi,Kore,Sene,10,2009,51,3,58,112
Oromia,East Hararge,Haromaya Town,Sene,10,2010,74,33,25,132
Oromia,Arsi,Tena,Tahesas,4,2010,2,79,6,87
Oromia,South West Shewa,Ilu,Meskerem,1,2011,18,41,6,65
Oromia,Ilu Aba Bora,Doreni,Nehase,12,2009,29,10,76,115
Oromia,Qeleme Wellega,Hawa Gelan,Tir,5,2010,15,92,94,201
Oromia,South West Shewa,Dawo,Megabit,7,2010,86,51,38,175
Oromia,West Shewa,Tibe Kutaye,Miyazia,8,2009,88,20,81,189
Oromia,East Hararge,Midega Tole,Sene,10,2009,13,50,32,95
Oromia,West Shewa,Bako Hospital,Hedar,3,2011,66,66,97,229
Oromia,South West Shewa,Woliso Rural,Hedar,3,2010,90,48,56,194
Oromia,Arsi,Munesa,Meskerem,1,2011,79,23,15,117
Oromia,Nekemte Town,Nekemte Town,Nehase,12,2010,95,68,5,168
Oromia,East Hararge,Kumbi,Teqemt,2,2010,66,91,71,228
Oromia,East Hararge,Garemuleta Hospital,Yekatit,6,2009,45,78,92,215
Oromia,West Arsi,Kore,Sene,10,2009,6,37,26,69
Oromia,South West Shewa,Sodo Dac'Ha,Megabit,7,2011,82,36,73,191
Oromia,Horo Gudru Wellega,Hababo Guduru,Ginbot,9,2009,69,94,89,252
Oromia,Buno Bedele,Bedele Town,Ginbot,9,2010,11,5,14,30
Oromia,West Guji,Dugda Dawa,Nehase,12,2009,89,88,35,212
Oromia,West Arsi,Kore,Hamle,11,2010,32,76,50,158
Oromia,Borena,Wachile,Ginbot,9,2010,20,12,13,45
Oromia,West Wellega,Mene Sibu,Yekatit,6,2010,60,61,43,164
Oromia,Arsi,Tiyo,Nehase,12,2009,53,27,95,175
Oromia,West Wellega,Boji Dermeji,Meskerem,1,2010,8,17,28,53
Oromia,West Wellega,Nejo Hospital,Meskerem,1,2010,18,99,9,126
Oromia,Jimma,Mana,Nehase,12,2010,99,14,64,177
Oromia,Bale,Dawe Serar,Ginbot,9,2009,14,77,79,170
Oromia,Arsi,Munesa,Hedar,3,2011,33,54,70,157
Oromia,South West Shewa,Sodo Dac'Ha,Megabit,7,2011,21,93,71,185
Oromia,West Wellega,Gimbi Rural,Megabit,7,2009,35,55,28,118
Oromia,Adama Special Town,Adama Town,Yekatit,6,2010,9,71,83,163
Oromia,West Wellega,Gimbi,Yekatit,6,2009,56,45,70,171
Oromia,Borena,Meyo,Teqemt,2,2010,3,78,5,86
Oromia,East Wellega,Gudeyabila,Megabit,7,2011,57,78,17,152
Oromia,Borena,Dhas,Ginbot,9,2010,95,32,47,174
Oromia,Jimma,B/Tolyi,Ginbot,9,2009,18,88,82,188
Oromia,East Hararge,Kurfa Chele,Meskerem,1,2010,65,49,87,201
Oromia,West Wellega,Mendi Town,Tir,5,2010,23,2,59,84
Oromia,West Arsi,Wondo,Teqemt,2,2010,32,75,80,187
Oromia,Borena,El Way,Hedar,3,2010,72,33,38,143
Oromia,Arsi,Robe,Meskerem,1,2010,9,80,57,146
Oromia,West Shewa,Chelia,Hamle,11,2009,85,16,23,124
Oromia,Jimma,Limu Seka,Meskerem,1,2010,25,38,89,152
Oromia,Arsi,Munesa,Ginbot,9,2011,50,48,56,154
Oromia,West Hararge,Daro Lebu,Hamle,11,2010,91,3,67,161
Oromia,Finfine Zuria,Mullo,Tahesas,4,2010,94,10,18,122
Oromia,Burayu Town,Burayu Town,Nehase,12,2010,91,34,81,206
Oromia,Bale,Ginir Town,Yekatit,6,2009,71,27,55,153
Oromia,East Hararge,Gursum,Sene,10,2010,82,12,5,99
Oromia,Guji,Shakiso Town,Yekatit,6,2009,98,58,22,178
Oromia,Borena,El Way,Miyazia,8,2010,60,26,60,146
Oromia,East Hararge,Gursum,Yekatit,6,2010,7,14,88,109
Oromia,Jimma,Dedo,Nehase,12,2010,87,34,48,169
Oromia,Horo Gudru Wellega,Horo,Nehase,12,2009,19,69,84,172
Oromia,Qeleme Wellega,Gawo Qebe,Ginbot,9,2009,43,14,83,140
Oromia,West Hararge,Guba Qoricha,Ginbot,9,2011,56,67,11,134
Oromia,East Wellega,Wama Hagelo,Tahesas,4,2011,6,20,53,79
Oromia,Borena,Dire,Yekatit,6,2009,27,94,40,161
Oromia,Guji,Bore,Meskerem,1,2011,80,42,48,170
Oromia,West Wellega,Jarso,Megabit,7,2009,69,0,89,158
Oromia,West Hararge,Meiso,Tir,5,2011,98,80,98,276
Oromia,South West Shewa,Goro,Megabit,7,2010,19,60,26,105
Oromia,Arsi,Enkelo Wabe,Megabit,7,2011,47,67,22,136
Oromia,West Shewa,Tibe Kutaye,Ginbot,9,2010,59,99,4,162
Oromia,Ilu Aba Bora,Algesachi,Hamle,11,2010,37,91,98,226
Oromia,Guji,Dima,Nehase,12,2009,53,43,80,176
Oromia,Bale,Dawe Serar,Hamle,11,2010,36,11,30,77
Oromia,West Wellega,Guliso,Tahesas,4,2010,20,18,72,110
Oromia,Ilu Aba Bora,Yayu,Tahesas,4,2010,8,23,71,102
Oromia,North Shewa,Wuchale,Sene,10,2009,19,67,46,132
Oromia,East Hararge,Jarso,Miyazia,8,2010,85,64,63,212
Oromia,East Hararge,Girawa,Megabit,7,2011,79,26,71,176
Oromia,Borena,Gomole,Sene,10,2010,69,51,95,215
Oromia,Borena,Yabelo,Miyazia,8,2011,65,56,91,212
Oromia,North Shewa,Kimbibit,Yekatit,6,2011,65,96,82,243
Oromia,South West Shewa,Sodo Dac'Ha,Yekatit,6,2009,47,19,81,147
Oromia,Finfine Zuria,Berreh,Nehase,12,2010,41,32,88,161
Oromia,Qeleme Wellega,Anfilo,Tir,5,2011,9,50,1,60
Oromia,West Hararge,Guba Qoricha,Miyazia,8,2011,91,72,39,202
Oromia,Finfine Zuria,Sululta Town,Teqemt,2,2011,77,55,23,155
Oromia,East Hararge,Chinakesen,Tir,5,2011,55,58,19,132
Oromia,East Hararge,Babile,Tahesas,4,2011,71,56,33,160
Oromia,West Wellega,Begi Hospital,Megabit,7,2009,57,4,66,127
Oromia,East Hararge,Kurfa Chele,Teqemt,2,2010,77,42,37,156
Oromia,Jimma,Dedo,Hamle,11,2010,51,38,21,110
Oromia,West Wellega,Nejo Hospital,Sene,10,2009,94,83,93,270
Oromia,East Wellega,Haro Limu,Sene,10,2010,43,18,92,153
Oromia,Arsi,Deksis,Hedar,3,2010,87,5,98,190
Oromia,Buno Bedele,Bedele Hospital,Meskerem,1,2011,6,23,15,44
Oromia,North Shewa,Hidabu Abote,Tahesas,4,2011,0,77,84,161
Oromia,West Wellega,Mendi Hospital,Teqemt,2,2010,36,40,22,98
Oromia,East Shewa,Dugda,Megabit,7,2011,91,42,38,171
Oromia,Bale,Delo Mena,Ginbot,9,2011,91,50,79,220
Oromia,Borena,Gomole,Meskerem,1,2011,82,91,38,211
Oromia,Borena,Gomole,Meskerem,1,2010,89,27,87,203
Oromia,Ilu Aba Bora,Ale,Hamle,11,2009,49,51,91,191
Oromia,West Guji,Bule Hora Hospital,Meskerem,1,2010,32,14,7,53
Oromia,Dukem Town,Dukem Town,Miyazia,8,2011,17,26,69,112
Oromia,Arsi,Digeluna Tijo,Ginbot,9,2010,17,81,16,114
Oromia,West Hararge,West Harerge	Gumbi Bordede,Ginbot,9,2009,62,33,96,191
Oromia,Bale,Goro,Yekatit,6,2011,40,23,55,118
Oromia,West Shewa,Ambo Hospital,Sene,10,2010,57,36,77,170
Oromia,West Arsi,Wondo,Sene,10,2010,19,72,28,119
Oromia,Finfine Zuria,Walmera,Megabit,7,2011,66,56,73,195
Oromia,North Shewa,Abichugna,Nehase,12,2009,97,8,85,190
Oromia,East Hararge,Midega Tole,Ginbot,9,2010,22,45,97,164
Oromia,East Hararge,Garemuleta Hospital,Hedar,3,2010,34,11,0,45
Oromia,Jimma,Agaro,Ginbot,9,2011,44,64,60,168
Oromia,North Shewa,Abichugna,Nehase,12,2009,79,60,29,168
Oromia,Qeleme Wellega,Gidami,Ginbot,9,2011,2,44,84,130
Oromia,Guji,Odo Shakiso,Teqemt,2,2010,69,14,84,167
Oromia,Finfine Zuria,Akaki,Miyazia,8,2010,38,17,98,153
Oromia,West Arsi,Kokosa,Sene,10,2010,70,52,85,207
Oromia,Ilu Aba Bora,Bure,Megabit,7,2011,90,94,32,216
Oromia,East Hararge,Bedeno,Meskerem,1,2011,20,84,76,180
Oromia,North Shewa,Fichetown,Hamle,11,2010,32,62,90,184
Oromia,North Shewa,Hidabu Abote,Yekatit,6,2009,14,73,94,181
Oromia,Guji,Negele Hospital,Tir,5,2011,47,41,99,187
Oromia,Bale,Delo Mena,Yekatit,6,2009,34,7,74,115
Oromia,Sululta Town,Sululta Town,Megabit,7,2011,23,34,76,133
Oromia,Buno Bedele,Diga,Megabit,7,2010,36,47,65,148
Oromia,Sululta Town,Sululta Town,Sene,10,2011,83,74,60,217
Oromia,East Wellega,Boneya Bushe,Hamle,11,2009,70,62,42,174
Oromia,West Shewa,Gindeberet Hospital,Meskerem,1,2011,42,50,6,98
Oromia,Ilu Aba Bora,Metu Rural,Hedar,3,2011,30,97,21,148
Oromia,West Hararge,West Harerge	Gumbi Bordede,Yekatit,6,2009,45,63,80,188
Oromia,Bale,Goba Town,Tir,5,2010,94,81,1,176
Oromia,South West Shewa,Dawo,Megabit,7,2010,60,81,98,239
Oromia,Bale,Legehida,Hedar,3,2010,82,94,42,218
Oromia,West Shewa,Gindeberet Hospital,Nehase,12,2010,91,30,51,172
Oromia,Borena,Wachile,Sene,10,2009,23,19,11,53
Oromia,West Wellega,Ayira Hospital,Megabit,7,2009,23,97,85,205
Oromia,Arsi,Merti,Tahesas,4,2011,52,43,98,193
Oromia,West Arsi,Shala,Sene,10,2009,16,81,46,143
Oromia,Arsi,Ludehetosa,Hedar,3,2011,47,9,92,148
Oromia,Jimma,Shabe,Sene,10,2009,30,62,13,105
Oromia,Jimma,Chora Boter,Meskerem,1,2010,8,7,36,51
Oromia,Bale,Ginir Town,Teqemt,2,2011,84,87,98,269
Oromia,Nekemte Town,Nekemte Town,Miyazia,8,2011,62,21,7,90
Oromia,West Arsi,Dodola Rural,Nehase,12,2009,51,18,15,84
Oromia,East Hararge,Deder,Yekatit,6,2009,28,49,27,104
Oromia,Arsi,Tena,Hamle,11,2010,95,57,1,153
Oromia,North Shewa,Jido,Tir,5,2009,61,99,40,200
Oromia,West Arsi,Shashemene Rural,Tir,5,2011,18,87,94,199
Oromia,East Hararge,Garemuleta Hospital,Hamle,11,2009,75,88,1,164
Oromia,Jimma,Mancho,Nehase,12,2010,30,88,62,180
Oromia,East Hararge,Haromaya Hospital,Meskerem,1,2011,25,30,17,72
Oromia,West Guji,Dugda Dawa,Hedar,3,2010,62,3,79,144
Oromia,West Arsi,Shala,Sene,10,2010,31,42,13,86
Oromia,East Hararge,Meyu Muleke,Tir,5,2009,40,85,39,164
Oromia,West Shewa,Guder Hosp,Hamle,11,2009,74,74,46,194
Oromia,North Shewa,Kimbibit,Nehase,12,2010,37,51,5,93
Oromia,East Hararge,Gole Oda,Nehase,12,2009,79,0,5,84
Oromia,Arsi,Guna,Meskerem,1,2010,56,45,37,138
Oromia,East Hararge,Midega Tole,Tahesas,4,2011,45,20,82,147
Oromia,Arsi,Aseko,Hedar,3,2011,63,24,32,119
Oromia,Jimma,Limu Kosa,Sene,10,2010,1,79,93,173
Oromia,West Arsi,Shala,Yekatit,6,2009,73,60,16,149
Oromia,East Shewa,Batu,Megabit,7,2009,61,76,84,221
Oromia,West Guji,Kercha Hospital,Tir,5,2009,66,24,95,185
Oromia,Arsi,Amigna,Tir,5,2009,0,51,11,62
Oromia,East Hararge,Haromaya Hospital,Teqemt,2,2010,50,98,91,239
Oromia,Borena,Teltele,Sene,10,2011,93,6,0,99
Oromia,Arsi,Jeju,Tir,5,2011,6,56,23,85
Oromia,West Hararge,Habro,Miyazia,8,2011,67,53,59,179
Oromia,Qeleme Wellega,Kake Hosp,Hedar,3,2011,97,66,90,253
Oromia,West Shewa,Meta Waliqite,Yekatit,6,2009,34,10,54,98
Oromia,West Hararge,Hawi Gudina,Hamle,11,2009,13,52,76,141
Oromia,North Shewa,Aleiltu,Tahesas,4,2010,60,76,43,179
Oromia,Horo Gudru Wellega,Gudru,Sene,10,2009,10,82,6,98
Oromia,Qeleme Wellega,Gawo Qebe,Yekatit,6,2009,63,23,98,184
Oromia,North Shewa,Abichugna,Tir,5,2010,22,13,46,81
Oromia,Adama Special Town,Adama Town,Tahesas,4,2010,66,36,84,186
Oromia,West Guji,Bule Hora Toun,Ginbot,9,2011,25,86,50,161
Oromia,West Wellega,Boji Dermeji,Miyazia,8,2009,97,76,74,247
Oromia,North Shewa,Kimbibit,Ginbot,9,2011,22,21,5,48
Oromia,West Wellega,Begi Hospital,Yekatit,6,2011,32,87,35,154
Oromia,Ilu Aba Bora,Darimu,Meskerem,1,2011,98,48,86,232
Oromia,Jimma,Omonada,Nehase,12,2010,1,27,76,104
Oromia,Qeleme Wellega,Dale Wabera,Hedar,3,2011,49,90,17,156
Oromia,Jimma,Sigmo,Tir,5,2010,24,85,6,115
Oromia,Guji,Gumi Eldallo,Sene,10,2009,92,27,15,134
Oromia,Arsi,Merti,Teqemt,2,2011,26,7,5,38
Oromia,Qeleme Wellega,Gidami,Megabit,7,2010,71,90,28,189
Oromia,Guji,Gumi Eldallo,Megabit,7,2010,15,64,47,126
Oromia,West Shewa,Codi,Tahesas,4,2011,93,61,48,202
Oromia,Guji,Girja,Yekatit,6,2011,46,0,31,77
Oromia,South West Shewa,Tole,Hamle,11,2009,90,11,83,184
Oromia,East Shewa,Adami Tulu Jido Kombolcha,Tahesas,4,2011,48,43,72,163
Oromia,East Shewa,Adea,Hedar,3,2011,29,81,28,138
Oromia,Jimma,Omonada,Tir,5,2011,18,51,73,142
Oromia,Arsi,Merti,Miyazia,8,2011,41,75,13,129
Oromia,Horo Gudru Wellega,Shambu Hospital,Meskerem,1,2011,76,96,58,230
Oromia,Qeleme Wellega,Gidami,Yekatit,6,2011,10,99,57,166
Oromia,East Hararge,Meyu Muleke,Sene,10,2010,79,17,41,137
Oromia,West Arsi,Arsi Negele Rural,Nehase,12,2010,7,82,35,124
Oromia,Bale,Robe Town,Tir,5,2009,96,84,99,279
Oromia,West Shewa,Bako Tibe,Hedar,3,2010,97,21,48,166
Oromia,West Guji,Abaya,Yekatit,6,2009,51,59,8,118
Oromia,South West Shewa,Ameya,Megabit,7,2009,71,4,45,120
Oromia,Guji,Girja,Hamle,11,2009,62,96,58,216
Oromia,West Arsi,Kokosa,Meskerem,1,2010,8,3,83,94
Oromia,West Guji,Dugda Dawa,Teqemt,2,2011,63,92,79,234
Oromia,Bale,Legehida,Miyazia,8,2010,34,78,38,150
Oromia,Bale,Raitu,Ginbot,9,2010,10,63,0,73
Oromia,West Wellega,Boji Dermeji,Miyazia,8,2010,66,13,91,170
Oromia,Ilu Aba Bora,Metu Rural,Ginbot,9,2010,33,86,18,137
Oromia,Arsi,Amigna,Tahesas,4,2011,60,13,84,157
Oromia,North Shewa,Yaya Gulele,Ginbot,9,2009,32,65,95,192
Oromia,West Shewa,Abuna Gindeberet,Hedar,3,2011,54,30,65,149
Oromia,Shashamane Town,Shashamane Town,Sene,10,2009,20,71,58,149
Oromia,Arsi,Aseko,Meskerem,1,2010,85,58,41,184
Oromia,Buno Bedele,Bedele Hospital,Nehase,12,2010,18,79,53,150
Oromia,West Shewa,Midakegni,Hamle,11,2010,19,54,65,138
Oromia,Jimma,Sekoru,Hedar,3,2011,27,39,44,110
Oromia,East Hararge,Goro Gutu,Sene,10,2011,11,10,51,72
Oromia,Arsi,Dodota,Ginbot,9,2010,23,6,34,63
Oromia,Arsi,Jeju,Nehase,12,2010,80,49,23,152
Oromia,Buno Bedele,Diga,Tir,5,2011,43,26,3,72
Oromia,Jimma,Kersa,Ginbot,9,2011,13,67,60,140
Oromia,West Wellega,Jarso,Tir,5,2011,85,98,0,183
Oromia,East Hararge,Garemuleta Hospital,Nehase,12,2009,53,47,37,137
Oromia,West Wellega,Ayira,Teqemt,2,2011,80,24,32,136
Oromia,Guji,Hambela Wamena,Megabit,7,2011,4,18,49,71
Oromia,West Hararge,Gelemso Hospital,Tir,5,2011,50,28,45,123
Oromia,North Shewa,Kuyu,Megabit,7,2010,12,60,85,157
Oromia,North Shewa,Yaya Gulele,Tir,5,2011,59,72,58,189
Oromia,Jimma,O/Beyam,Ginbot,9,2011,33,28,47,108
Oromia,Guji,Liben,Nehase,12,2009,16,70,70,156
Oromia,Jimma,Setema,Sene,10,2009,96,3,56,155
Oromia,West Wellega,Qiltu Kara,Hedar,3,2010,51,26,68,145
Oromia,Guji,Adola Reda,Ginbot,9,2011,43,39,74,156
Oromia,Guji,Girja,Hedar,3,2011,38,53,3,94
Oromia,Jimma,Setema,Nehase,12,2010,89,28,89,206
Oromia,West Shewa,Ilu Galan,Tir,5,2009,29,30,50,109
Oromia,West Shewa,Guder Hosp,Hedar,3,2011,80,90,54,224
Oromia,Bale,Sinana,Yekatit,6,2010,42,86,5,133
Oromia,West Wellega,Homa,Sene,10,2009,63,25,6,94
Oromia,Borena,Meyo,Teqemt,2,2011,66,93,50,209
Oromia,Dukem Town,Dukem Town,Ginbot,9,2010,78,9,59,146
Oromia,Qeleme Wellega,Hawa Gelan,Tahesas,4,2011,20,89,6,115
Oromia,West Arsi,Arsi Negele Rural,Tir,5,2009,0,66,79,145
Oromia,East Hararge,Chelenko Hospital,Ginbot,9,2011,74,26,70,170
Oromia,Jimma,Omonada,Megabit,7,2009,84,6,63,153
Oromia,Guji,Gumi Eldallo,Teqemt,2,2011,77,44,35,156
Oromia,West Shewa,Meta Waliqite,Ginbot,9,2010,66,39,41,146
Oromia,West Shewa,Dano,Sene,10,2011,31,87,80,198
Oromia,Ilu Aba Bora,Ale,Tir,5,2009,66,35,85,186
Oromia,West Arsi,Hebal Arsi,Megabit,7,2010,94,20,33,147
Oromia,Guji,Wadara,Tahesas,4,2010,64,76,2,142
Oromia,East Hararge,Girawa,Ginbot,9,2011,17,85,35,137
Oromia,West Wellega,Ayira Hospital,Meskerem,1,2010,35,80,89,204
Oromia,West Arsi,Siraro,Miyazia,8,2011,42,74,90,206
Oromia,West Shewa,Nono,Yekatit,6,2009,57,64,17,138
Oromia,Finfine Zuria,Sebeta Awas,Yekatit,6,2010,3,85,48,136
Oromia,Qeleme Wellega,Dambi Dolo Hospital,Tahesas,4,2010,8,4,53,65
Oromia,East Hararge,Meyu Muleke,Tahesas,4,2011,92,38,22,152
Oromia,Assela Town,Assela Town,Nehase,12,2009,68,2,45,115
Oromia,Guji,Hambela Wamena,Sene,10,2009,11,26,80,117
Oromia,Horo Gudru Wellega,Gudru,Miyazia,8,2011,25,56,55,136
Oromia,Bishoftu Town,Bishoftu Town,Tahesas,4,2011,50,48,36,134
Oromia,West Wellega,Nejo Town,Yekatit,6,2011,61,37,20,118
Oromia,West Hararge,Burka Dimtu,Sene,10,2010,87,31,38,156
Oromia,Jimma,Mancho,Ginbot,9,2010,99,36,5,140
Oromia,Borena,El Way,Hedar,3,2010,8,59,68,135
Oromia,West Shewa,Adea Berga,Miyazia,8,2009,87,71,24,182
Oromia,South West Shewa,Becho,Hamle,11,2010,50,64,64,178
Oromia,Borena,Dubluk,Nehase,12,2010,28,21,13,62
Oromia,West Shewa,Midakegni,Sene,10,2010,88,16,66,170
Oromia,Qeleme Wellega,Laloqile,Miyazia,8,2009,32,77,18,127
Oromia,West Hararge,Hawi Gudina,Miyazia,8,2011,87,74,8,169
Oromia,West Shewa,Ilu Galan,Ginbot,9,2010,35,81,30,146
Oromia,West Shewa,Dendi,Tir,5,2010,74,60,45,179
Oromia,Finfine Zuria,Berreh,Sene,10,2009,0,29,90,119
Oromia,West Hararge,Daro Lebu,Hedar,3,2011,3,68,0,71
Oromia,South West Shewa,Tole,Sene,10,2009,67,65,51,183
Oromia,Ilu Aba Bora,Metu Town,Nehase,12,2010,7,11,47,65
Oromia,East Shewa,Bora,Megabit,7,2011,39,67,2,108
Oromia,Buno Bedele,Diga,Tir,5,2011,2,12,79,93
Oromia,East Wellega,Diga,Miyazia,8,2011,85,58,9,152
Oromia,West Hararge,Boke,Tir,5,2010,58,67,79,204
Oromia,Bale,Agarfa,Tir,5,2010,90,84,6,180
Oromia,Horo Gudru Wellega,Horo,Nehase,12,2009,27,0,65,92
Oromia,Borena,Dilo,Megabit,7,2010,88,33,53,174
Oromia,Qeleme Wellega,Yemalogi Wolel,Meskerem,1,2011,12,93,52,157
Oromia,Guji,Bore,Tahesas,4,2010,53,96,32,181
Oromia,East Hararge,Fedis,Hamle,11,2009,92,44,58,194
Oromia,West Wellega,Yubdo,Ginbot,9,2009,79,58,49,186
Oromia,Jimma,Nono Benja,Sene,10,2010,55,77,67,199
Oromia,West Hararge,Chiro Zuriya,Tir,5,2009,4,87,55,146
Oromia,Ilu Aba Bora,Doreni,Sene,10,2011,54,16,73,143
Oromia,Arsi,Guna,Sene,10,2010,17,78,8,103
Oromia,West Arsi,Nensebo,Megabit,7,2010,63,53,38,154
Oromia,West Shewa,Liban Jawi,Sene,10,2009,69,71,70,210
Oromia,Jimma,B/Tolyi,Nehase,12,2009,85,88,69,242
Oromia,East Shewa,Bora,Hedar,3,2011,61,27,89,177
Oromia,West Guji,Bule Hora,Megabit,7,2011,81,51,28,160
Oromia,Guji,Aga Wayyu,Meskerem,1,2010,65,50,90,205
Oromia,West Shewa,Metarobi,Megabit,7,2010,1,97,49,147
Oromia,Jimma,Setema,Ginbot,9,2009,23,21,61,105
Oromia,East Shewa,Fentale,Meskerem,1,2011,20,76,60,156
Oromia,Borena,Teltele,Nehase,12,2010,38,87,88,213
Oromia,East Hararge,Chelenko Hospital,Miyazia,8,2010,19,4,73,96
Oromia,Sebeta Town,Sebeta Town,Hamle,11,2009,20,26,59,105
Oromia,East Wellega,Gudeyabila,Nehase,12,2009,60,5,89,154
Oromia,North Shewa,Hidabu Abote,Sene,10,2010,77,78,56,211
Oromia,West Shewa,Gindeberet Hospital,Tir,5,2011,64,26,13,103
Oromia,Bale,Dawe Serar,Tahesas,4,2011,36,1,48,85
Oromia,Horo Gudru Wellega,Abay Chomen,Miyazia,8,2010,51,36,38,125
Oromia,Bale,Dawe Serar,Ginbot,9,2010,79,41,72,192
Oromia,Arsi,Tena,Hamle,11,2009,99,45,29,173
Oromia,West Shewa,Adea Berga,Tir,5,2010,72,63,87,222
Oromia,Bale,Legehida,Hamle,11,2010,95,94,16,205
Oromia,Bale,Sinana,Hedar,3,2011,36,69,45,150
Oromia,East Wellega,Guto Gida,Tahesas,4,2010,66,84,39,189
Oromia,Borena,Wachile,Hedar,3,2010,19,68,4,91
Oromia,Guji,Adola Hospital,Hamle,11,2010,67,45,15,127
Oromia,West Arsi,Bishan Guracha Town,Hamle,11,2010,86,71,61,218
Oromia,North Shewa,Kuyu Hospital,Teqemt,2,2011,0,61,97,158
Oromia,Guji,Adola Hospital,Teqemt,2,2011,13,29,74,116
Oromia,West Wellega,Mene Sibu,Tahesas,4,2010,74,66,25,165
Oromia,North Shewa,Fichetown,Hamle,11,2010,40,69,25,134
Oromia,Arsi,Bekoji Town,Tir,5,2009,14,61,57,132
Oromia,West Hararge,Burka Dimtu,Tir,5,2009,38,63,71,172
Oromia,West Shewa,Inchini Hospital,Megabit,7,2010,57,48,2,107
Oromia,West Wellega,Gimbi Rural,Meskerem,1,2011,46,30,88,164
Oromia,Bale,Delo Mena,Teqemt,2,2010,94,45,20,159
Oromia,West Wellega,Mene Sibu,Miyazia,8,2011,10,59,13,82
Oromia,Jimma,Sekoru,Ginbot,9,2009,69,86,33,188
Oromia,Arsi,Enkelo Wabe,Sene,10,2010,57,34,52,143
Oromia,Buno Bedele,Chora,Ginbot,9,2011,65,74,50,189
Oromia,Ilu Aba Bora,Doreni,Teqemt,2,2010,18,79,93,190
Oromia,East Shewa,Boset,Tir,5,2011,78,0,62,140
Oromia,Horo Gudru Wellega,Horro Buluk,Ginbot,9,2010,66,3,70,139
Oromia,West Guji,Gelana,Tahesas,4,2010,98,3,47,148
Oromia,East Shewa,Adea,Meskerem,1,2010,42,90,95,227
Oromia,Borena,Dire,Yekatit,6,2010,82,51,83,216
Oromia,West Guji,Mkelka Soda,Miyazia,8,2010,84,54,56,194
Oromia,Guji,Shakiso Town,Megabit,7,2009,34,51,21,106
Oromia,West Hararge,Meiso,Tir,5,2009,73,92,40,205
Oromia,West Shewa,Chelia,Megabit,7,2010,67,58,72,197
Oromia,West Shewa,Adea Berga,Yekatit,6,2011,80,32,41,153
Oromia,Jimma,Seka Chekorsa,Tir,5,2009,80,1,70,151
Oromia,Modjo Town,Modjo Town,Megabit,7,2010,18,63,30,111
Oromia,West Wellega,Babo Gembel,Nehase,12,2009,46,67,59,172
Oromia,West Wellega,Homa,Megabit,7,2009,48,52,25,125
Oromia,South West Shewa,Ameya,Miyazia,8,2011,11,93,34,138
Oromia,East Shewa,Lomme,Yekatit,6,2009,97,61,86,244
Oromia,Borena,Yabelo,Tir,5,2011,91,41,62,194
Oromia,Guji,Bore,Hamle,11,2010,45,90,34,169
Oromia,North Shewa,Hidabu Abote,Meskerem,1,2010,29,33,35,97
Oromia,East Hararge,Fedis,Hedar,3,2010,31,17,36,84
Oromia,West Shewa,Jeldu,Meskerem,1,2011,75,35,59,169
Oromia,North Shewa,Hidabu Abote,Ginbot,9,2011,43,97,81,221
Oromia,Ilu Aba Bora,Darimu,Megabit,7,2010,47,66,39,152
Oromia,West Shewa,Nono,Tahesas,4,2011,78,18,95,191
Oromia,East Hararge,Haromaya Rural,Miyazia,8,2010,35,27,2,64
Oromia,Assela Town,Assela Town,Yekatit,6,2010,66,29,12,107
Oromia,North Shewa,Yaya Gulele,Megabit,7,2011,32,31,86,149
Oromia,East Hararge,Haromaya Hospital,Meskerem,1,2011,64,39,59,162
Oromia,Bale,Dawe Qachen,Megabit,7,2010,85,66,2,153
Oromia,East Hararge,Jarso,Sene,10,2011,73,83,37,193
Oromia,North Shewa,Yaya Gulele,Yekatit,6,2009,98,82,46,226
Oromia,West Wellega,Gimbi,Miyazia,8,2010,78,51,69,198
Oromia,East Shewa,Gimbichu,Yekatit,6,2011,99,64,84,247
Oromia,Buno Bedele,Bedele Hospital,Miyazia,8,2011,13,6,67,86
Oromia,Jimma,Kersa,Hamle,11,2009,82,85,70,237
Oromia,East Wellega,Sasiga,Sene,10,2009,71,54,5,130
Oromia,Bale,Seweyna,Megabit,7,2011,53,35,57,145
Oromia,Jimma,Omonada,Tahesas,4,2011,61,33,98,192
Oromia,South West Shewa,Dawo,Tir,5,2010,41,80,97,218
Oromia,West Wellega,Homa,Tir,5,2011,74,45,13,132
Oromia,Borena,Moyale Hospital,Teqemt,2,2010,69,15,14,98
Oromia,West Shewa,Elifata,Yekatit,6,2009,69,7,15,91
Oromia,Bale,Gololcha,Hamle,11,2009,49,66,44,159
Oromia,South West Shewa,Bantu  Hospital,Hamle,11,2010,74,98,53,225
Oromia,West Guji,Mkelka Soda,Megabit,7,2009,85,69,34,188
Oromia,East Hararge,Aweday Town,Tahesas,4,2010,67,16,42,125
Oromia,Jimma,Mancho,Meskerem,1,2010,53,19,69,141
Oromia,East Shewa,Matahara,Hamle,11,2009,3,43,15,61
Oromia,Finfine Zuria,Holeta,Yekatit,6,2009,84,4,37,125
Oromia,West Arsi,Arsi Negele Town,Tahesas,4,2010,75,3,87,165
Oromia,East Shewa,Boset,Teqemt,2,2011,68,34,27,129
Oromia,West Guji,Bule Hora,Megabit,7,2009,8,2,69,79
Oromia,South West Shewa,Becho,Miyazia,8,2009,16,27,51,94
Oromia,West Guji,Suro Barguda,Hedar,3,2011,21,10,4,35
Oromia,West Shewa,Jeldu,Tahesas,4,2011,48,10,21,79
Oromia,West Shewa,Ilu Galan,Megabit,7,2010,94,18,6,118
Oromia,Guji,Gumi Eldallo,Meskerem,1,2011,41,23,56,120
Oromia,Qeleme Wellega,Sedan Chanka,Yekatit,6,2010,3,83,10,96
Oromia,West Wellega,Lata Sibu,Ginbot,9,2011,30,75,12,117
Oromia,West Wellega,Begi,Ginbot,9,2010,27,75,78,180
Oromia,East Hararge,Kurfa Chele,Tahesas,4,2010,80,42,12,134
Oromia,Arsi,Ludehetosa,Tahesas,4,2011,88,97,36,221
Oromia,Robe Town,Robe Town,Megabit,7,2010,47,85,87,219
Oromia,Arsi,Shirka,Megabit,7,2010,74,93,84,251
Oromia,Jimma,B/Tolyi,Megabit,7,2010,56,93,5,154
Oromia,West Shewa,Jeldu,Tahesas,4,2011,20,0,23,43
Oromia,Bale,Goba,Tir,5,2011,92,77,46,215
Oromia,Borena,Arero,Meskerem,1,2011,78,76,55,209
Oromia,Arsi,Shirka,Tahesas,4,2011,53,29,38,120
Oromia,Bishoftu Town,Bishoftu Town,Meskerem,1,2010,46,64,76,186
Oromia,West Hararge,Gelemso Hospital,Teqemt,2,2010,38,33,45,116
Oromia,West Arsi,Shashemene Rural,Ginbot,9,2011,99,12,84,195
Oromia,Arsi,Sude,Sene,10,2009,94,24,60,178
Oromia,Jimma,Mancho,Hamle,11,2009,59,65,6,130
Oromia,West Guji,Gelana,Tir,5,2009,52,48,29,129
Oromia,Bale,Gololcha,Megabit,7,2010,12,25,12,49
Oromia,West Arsi,Dodola Town,Hamle,11,2009,59,27,62,148
Oromia,South West Shewa,Ameya,Miyazia,8,2011,54,61,93,208
Oromia,Jimma,Nono Benja,Teqemt,2,2011,66,51,35,152
Oromia,West Wellega,Nejo Rural,Meskerem,1,2011,56,97,51,204
Oromia,West Hararge,Gelemso Hospital,Miyazia,8,2009,8,5,26,39
Oromia,East Shewa,Boset,Meskerem,1,2011,7,58,11,76
Oromia,Ilu Aba Bora,Algesachi,Hamle,11,2010,57,56,31,144
Oromia,North Shewa,Wuchale,Megabit,7,2011,69,48,50,167
Oromia,East Hararge,Jarso,Tir,5,2009,53,34,59,146
Oromia,South West Shewa,St.Luke Hospital,Megabit,7,2010,75,6,24,105
Oromia,Shashamane Town,Shashamane Town,Megabit,7,2010,74,50,52,176
Oromia,Buno Bedele,Boricha,Sene,10,2009,70,44,96,210
Oromia,Bale,Goro,Tir,5,2011,83,10,91,184
Oromia,Qeleme Wellega,Gidami,Tir,5,2011,88,41,49,178
Oromia,West Hararge,West Harerge	Gumbi Bordede,Miyazia,8,2010,55,43,52,150
Oromia,Ilu Aba Bora,Yayu,Miyazia,8,2009,68,10,84,162
Oromia,Horo Gudru Wellega,Jima Geneti,Sene,10,2010,26,80,44,150
Oromia,West Shewa,Bako Tibe,Meskerem,1,2011,35,27,35,97
Oromia,East Wellega,Jimma Arjo,Miyazia,8,2010,68,26,74,168
Oromia,West Guji,Hanbala,Tir,5,2009,71,75,16,162
Oromia,North Shewa,Abichugna,Miyazia,8,2009,89,29,90,208
Oromia,Sululta Town,Sululta Town,Hamle,11,2009,76,37,48,161
Oromia,West Shewa,Bako Tibe,Tir,5,2011,6,40,32,78
Oromia,West Hararge,Habro,Miyazia,8,2010,43,91,42,176
Oromia,East Hararge,Kombolicha,Sene,10,2010,90,90,59,239
Oromia,Borena,Teltele,Tir,5,2009,93,53,77,223
Oromia,West Hararge,Habro,Yekatit,6,2009,41,21,48,110
Oromia,East Hararge,Jarso,Hedar,3,2010,12,38,27,77
Oromia,Jimma,Sigmo,Yekatit,6,2009,99,64,85,248
Oromia,Bale,Gololcha,Meskerem,1,2010,38,49,85,172
Oromia,West Hararge,Gelemso Hospital,Tahesas,4,2011,64,14,59,137
Oromia,West Wellega,Ayira,Sene,10,2010,14,78,51,143
Oromia,Arsi,Merti,Nehase,12,2010,26,20,84,130
Oromia,East Hararge,Kumbi,Meskerem,1,2011,3,32,40,75
Oromia,Guji,Liben,Tir,5,2011,39,29,20,88
Oromia,Horo Gudru Wellega,Jima Geneti,Miyazia,8,2010,45,71,52,168
Oromia,East Hararge,Midega Tole,Sene,10,2010,90,89,28,207
Oromia,Jimma,B/Tolyi,Hamle,11,2009,47,12,34,93
Oromia,Arsi,Sude,Miyazia,8,2011,5,2,14,21
Oromia,North Shewa,Aleiltu,Tir,5,2010,68,14,77,159
Oromia,Ilu Aba Bora,Didu,Tir,5,2009,97,54,88,239
Oromia,Jimma,Kersa,Hamle,11,2009,1,18,93,112
Oromia,Qeleme Wellega,Gidami Hosp,Miyazia,8,2011,87,50,85,222
Oromia,East Shewa,Adami Tulu Jido Kombolcha,Tir,5,2009,83,21,23,127
Oromia,Guji,Uraga,Ginbot,9,2011,66,82,85,233
Oromia,Jimma,Setema,Teqemt,2,2011,53,84,45,182
Oromia,West Wellega,Seyo Nole,Hamle,11,2010,10,29,79,118
Oromia,Buno Bedele,Dapho Hana,Hedar,3,2010,44,39,39,122
Oromia,Burayu Town,Burayu Town,Nehase,12,2010,45,49,80,174
Oromia,Finfine Zuria,Berreh,Hamle,11,2009,64,12,37,113
Oromia,West Guji,Mkelka Soda,Tahesas,4,2010,32,25,53,110
Oromia,West Arsi,Wondo,Meskerem,1,2010,15,62,50,127
Oromia,West Guji,Bule Hora,Megabit,7,2010,86,2,64,152
Oromia,Ilu Aba Bora,Algesachi,Hamle,11,2009,86,54,48,188
Oromia,Buno Bedele,Diga,Tahesas,4,2010,89,86,34,209
Oromia,Qeleme Wellega,Jimma Horo,Tahesas,4,2010,39,36,68,143
Oromia,West Arsi,Kore,Miyazia,8,2009,52,4,18,74
Oromia,West Shewa,Dano,Ginbot,9,2009,78,77,85,240
Oromia,Jimma,B/Tolyi,Miyazia,8,2010,32,30,99,161
Oromia,Guji,Wadara,Miyazia,8,2010,20,11,46,77
Oromia,Arsi,Zeway Dugda,Nehase,12,2009,97,61,84,242
Oromia,North Shewa,Kuyu,Megabit,7,2010,74,20,78,172
Oromia,East Wellega,Wayu Tuqa,Miyazia,8,2010,8,89,8,105
Oromia,West Wellega,Boji Dermeji,Nehase,12,2009,45,7,9,61
Oromia,West Arsi,Arsi Negele Rural,Tahesas,4,2011,52,76,53,181
Oromia,North Shewa,Degem,Ginbot,9,2009,58,16,53,127
Oromia,East Hararge,Bisidimo Hospital,Yekatit,6,2009,0,52,85,137
Oromia,West Guji,Kercha Hospital,Sene,10,2009,65,52,22,139
Oromia,East Wellega,Boneya Bushe,Tir,5,2010,50,74,96,220
Oromia,Borena,Dubluk,Ginbot,9,2009,22,78,23,123
Oromia,West Wellega,Babo Gembel,Ginbot,9,2010,13,85,49,147
Oromia,East Wellega,Diga,Nehase,12,2009,49,70,98,217
Oromia,East Hararge,Deder,Teqemt,2,2011,39,18,78,135
Oromia,West Shewa,Gedo Hospital,Tir,5,2009,99,82,46,227
Oromia,West Hararge,Doba,Ginbot,9,2010,68,27,42,137
Oromia,Bale,Ginir Town,Hamle,11,2009,10,80,56,146
Oromia,Borena,Dhas,Ginbot,9,2011,86,33,3,122
Oromia,West Wellega,Yubdo,Miyazia,8,2009,16,55,48,119
Oromia,East Wellega,Gida Ayana,Tir,5,2010,32,88,76,196
Oromia,Shashamane Town,Shashamane Town,Hedar,3,2011,46,78,96,220
Oromia,West Arsi,Gedeb Asasa,Tahesas,4,2011,43,35,85,163
Oromia,Sululta Town,Sululta Town,Nehase,12,2009,42,57,84,183
Oromia,East Hararge,Babile,Megabit,7,2010,24,90,72,186
Oromia,East Shewa,Matahara,Tir,5,2011,34,4,76,114
Oromia,North Shewa,Hidabu Abote,Tahesas,4,2010,54,48,89,191
Oromia,North Shewa,Kuyu,Tahesas,4,2011,91,54,62,207
Oromia,Buno Bedele,Meko,Tir,5,2009,29,26,38,93
Oromia,East Hararge,Goro Gutu,Nehase,12,2009,47,87,50,184
Oromia,South West Shewa,Goro,Tir,5,2009,9,50,58,117
Oromia,Arsi,Guna,Miyazia,8,2011,34,70,48,152
Oromia,West Hararge,Gelemso Hospital,Hedar,3,2011,52,89,46,187
Oromia,Guji,Negele Hospital,Tir,5,2010,20,59,31,110
Oromia,Guji,Anna Sora,Hamle,11,2010,82,50,42,174
Oromia,Jimma,Mana,Hedar,3,2011,67,33,59,159
Oromia,West Hararge,Chiro Town,Yekatit,6,2011,16,74,76,166
Oromia,Jimma,Mana,Yekatit,6,2010,41,25,50,116
Oromia,West Arsi,Arsi Negele Town,Miyazia,8,2010,15,50,24,89
Oromia,Borena,Yabelo,Hedar,3,2011,8,3,43,54
Oromia,West Wellega,Ayira Hospital,Yekatit,6,2011,32,54,72,158
Oromia,Buno Bedele,Chora,Tahesas,4,2010,86,77,29,192
Oromia,Bale,Gasera,Sene,10,2009,65,37,10,112
Oromia,Ilu Aba Bora,Nono Sele,Teqemt,2,2011,65,49,92,206
Oromia,West Hararge,Anchar,Hamle,11,2010,99,50,6,155
Oromia,Buno Bedele,Dedesa,Miyazia,8,2010,71,38,76,185
Oromia,Jimma,Omonada,Meskerem,1,2011,42,48,18,108
Oromia,Jimma,B/Tolyi,Megabit,7,2009,31,39,37,107
Oromia,Jimma,Sekoru,Yekatit,6,2009,37,46,23,106
Oromia,West Shewa,Jeldu,Teqemt,2,2011,43,70,96,209
Oromia,West Shewa,Guder Hosp,Ginbot,9,2011,71,3,26,100
Oromia,Guji,Adola Hospital,Sene,10,2009,23,34,7,64
Oromia,Borena,Arero,Tir,5,2011,69,44,73,186
Oromia,Jimma,Limu Kosa,Sene,10,2009,13,84,79,176
Oromia,Bishoftu Town,Bishoftu Town,Hedar,3,2011,58,65,98,221
Oromia,Buno Bedele,Gechi,Tir,5,2011,1,54,61,116
Oromia,West Shewa,Chelia,Tahesas,4,2010,47,44,31,122
Oromia,Guji,Hambela Wamena,Yekatit,6,2009,75,58,48,181
Oromia,West Wellega,Seyo Nole,Ginbot,9,2011,29,80,34,143
Oromia,East Hararge,Meyu Muleke,Nehase,12,2010,1,95,0,96
Oromia,Arsi,Gololcha,Hamle,11,2009,71,47,53,171
Oromia,Horo Gudru Wellega,Jarte Jardga,Sene,10,2011,42,75,99,216
Oromia,South West Shewa,Wonchi,Ginbot,9,2010,79,84,9,172
Oromia,Horo Gudru Wellega,Horro Buluk,Meskerem,1,2011,99,75,71,245
Oromia,West Hararge,Mesela,Tahesas,4,2010,90,48,2,140
Oromia,East Wellega,Sasiga,Megabit,7,2010,67,4,40,111
Oromia,Adama Special Town,Adama Town,Hamle,11,2010,67,42,46,155
Oromia,Borena,Moyale,Tahesas,4,2011,27,16,82,125
Oromia,Jimma,Mana,Miyazia,8,2010,2,34,46,82
Oromia,Ilu Aba Bora,Doreni,Nehase,12,2010,30,50,76,156
Oromia,East Hararge,Deder Hospital,Megabit,7,2011,55,73,55,183
Oromia,Arsi,Enkelo Wabe,Ginbot,9,2011,50,54,16,120
Oromia,West Shewa,Jeldu,Megabit,7,2009,40,26,45,111
Oromia,West Arsi,Siraro,Megabit,7,2010,95,11,90,196
Oromia,Ilu Aba Bora,Halu,Hamle,11,2009,90,7,17,114
Oromia,West Shewa,Dano,Miyazia,8,2010,58,80,27,165
Oromia,West Wellega,Genji,Ginbot,9,2010,34,19,4,57
Oromia,Jimma,Sekoru,Nehase,12,2009,36,29,93,158
Oromia,West Hararge,West Harerge	Gumbi Bordede,Tir,5,2010,7,22,74,103
Oromia,West Hararge,Burka Dimtu,Miyazia,8,2009,44,98,8,150
Oromia,West Shewa,Jeldu,Meskerem,1,2011,30,22,89,141
Oromia,East Hararge,Haromaya Hospital,Tir,5,2011,81,69,29,179
Oromia,West Arsi,Gedeb Asasa,Yekatit,6,2010,93,66,43,202
Oromia,West Hararge,Doba,Hamle,11,2010,7,47,54,108
Oromia,Horo Gudru Wellega,Horo,Ginbot,9,2010,22,61,22,105
Oromia,East Shewa,Fentale,Tahesas,4,2010,31,6,74,111
Oromia,Arsi,Deksis,Sene,10,2011,65,24,88,177
Oromia,Guji,Adola Reda,Yekatit,6,2009,85,89,9,183
Oromia,West Guji,Bule Hora,Hamle,11,2009,61,31,46,138
Oromia,West Wellega,Qiltu Kara,Meskerem,1,2010,56,41,49,146
Oromia,Ilu Aba Bora,Hurumu,Nehase,12,2010,54,52,57,163
Oromia,Ilu Aba Bora,Yayu,Sene,10,2010,35,94,27,156
Oromia,Borena,Moyale Hospital,Meskerem,1,2010,34,75,91,200
Oromia,Arsi,Jeju,Hamle,11,2010,54,18,91,163
Oromia,West Shewa,Inchini Hospital,Tahesas,4,2011,43,7,36,86
Oromia,East Wellega,Haro Limu,Hedar,3,2010,58,31,10,99
Oromia,Arsi,Tena,Yekatit,6,2010,40,7,34,81
Oromia,East Shewa,Boset,Meskerem,1,2010,26,78,17,121
Oromia,West Guji,Dugda Dawa,Ginbot,9,2009,38,9,29,76
Oromia,West Shewa,Midakegni,Hedar,3,2011,71,84,52,207
Oromia,West Arsi,Adaba,Ginbot,9,2010,92,13,72,177
Oromia,West Arsi,Nensebo,Sene,10,2010,62,12,99,173
Oromia,West Shewa,Metarobi,Sene,10,2009,80,81,56,217
Oromia,Qeleme Wellega,Sedan Chanka,Sene,10,2010,15,78,95,188
Oromia,North Shewa,Aleiltu,Nehase,12,2009,21,95,49,165
Oromia,East Hararge,Bisidimo Hospital,Tir,5,2010,27,60,24,111
Oromia,Jimma Spe Town,Jimma Spe Town,Sene,10,2010,62,75,36,173
Oromia,Guji,Negele Hospital,Meskerem,1,2010,20,71,15,106
Oromia,Adama Special Town,Adama Town,Ginbot,9,2011,97,88,47,232
Oromia,East Wellega,Haro Limu,Nehase,12,2010,48,90,0,138
Oromia,West Arsi,Kofele,Hedar,3,2010,29,63,24,116
Oromia,South West Shewa,Tulu Bolo Hospital,Hedar,3,2011,95,70,5,170
Oromia,West Shewa,Inchini Hospital,Meskerem,1,2011,12,67,74,153
Oromia,West Shewa,Guder Hosp,Miyazia,8,2011,43,89,71,203
Oromia,North Shewa,Girar Jarso,Miyazia,8,2010,5,39,87,131
Oromia,Arsi,Sire,Hedar,3,2010,64,21,55,140
Oromia,Arsi,Tena,Sene,10,2009,30,27,90,147
Oromia,Buno Bedele,Bedele Zuriya,Ginbot,9,2011,89,78,92,259
Oromia,West Wellega,Nejo Town,Tahesas,4,2011,55,45,60,160
Oromia,Bale,Arena Buluq,Teqemt,2,2010,47,65,74,186
Oromia,South West Shewa,Ameya,Ginbot,9,2009,73,92,36,201
Oromia,West Wellega,Guliso,Tahesas,4,2011,5,59,83,147
Oromia,Borena,Meyo,Hamle,11,2010,31,8,15,54
Oromia,Qeleme Wellega,Hawa Gelan,Sene,10,2011,96,54,85,235
Oromia,Jimma,Sigmo,Teqemt,2,2011,16,70,98,184
Oromia,Arsi,Tiyo,Teqemt,2,2011,64,83,30,177
Oromia,Lege Dadi Lege Tafo Town,Lege Dadi Lege Tafo Town,Megabit,7,2011,64,39,53,156
Oromia,South West Shewa,Ilu,Yekatit,6,2010,67,97,23,187
Oromia,Ilu Aba Bora,Nono Sele,Hamle,11,2009,83,1,59,143
Oromia,Jimma,Omonada,Tahesas,4,2010,21,11,94,126
Oromia,East Shewa,Adea,Meskerem,1,2011,33,90,2,125
Oromia,Borena,Moyale Hospital,Ginbot,9,2010,97,46,52,195
Oromia,West Shewa,Elifata,Miyazia,8,2010,13,4,48,65
Oromia,Jimma,Kersa,Tahesas,4,2011,94,98,27,219
Oromia,West Wellega,Ayira Hospital,Sene,10,2009,78,74,5,157
Oromia,West Wellega,Nejo Hospital,Yekatit,6,2010,18,98,35,151
Oromia,East Wellega,Kiremu,Nehase,12,2009,97,37,66,200
Oromia,West Shewa,Metarobi,Megabit,7,2011,32,23,92,147
Oromia,West Wellega,Begi Hospital,Tahesas,4,2010,70,76,56,202
Oromia,Guji,Goro Dola,Yekatit,6,2010,93,40,12,145
Oromia,East Wellega,Nunu Qumba,Hedar,3,2010,98,18,54,170
Oromia,Jimma,Sigmo,Sene,10,2009,5,9,0,14
Oromia,East Hararge,Goro Gutu,Nehase,12,2009,18,72,74,164
Oromia,South West Shewa,Ameya,Ginbot,9,2010,24,16,82,122
Oromia,Guji,Gumi Eldallo,Nehase,12,2009,99,99,2,200
Oromia,West Wellega,Genji,Hamle,11,2010,64,49,58,171
Oromia,Bale,Dinsho,Tahesas,4,2011,70,18,35,123
Oromia,Ilu Aba Bora,Darimu,Teqemt,2,2011,49,52,2,103
Oromia,East Hararge,Kombolicha,Meskerem,1,2010,0,54,30,84
Oromia,Jimma,Dedo,Tir,5,2009,4,59,59,122
Oromia,Bale,Sinana,Hedar,3,2010,24,18,36,78
Oromia,West Shewa,Bako Tibe,Tir,5,2009,28,47,14,89
Oromia,East Hararge,Deder,Ginbot,9,2009,35,3,84,122
Oromia,Arsi,Sude,Meskerem,1,2011,3,16,28,47
Oromia,Arsi,Tiyo,Yekatit,6,2011,42,43,28,113
Oromia,Finfine Zuria,Sululta Town,Nehase,12,2009,80,75,84,239
Oromia,North Shewa,Abichugna,Ginbot,9,2010,23,15,3,41
Oromia,Guji,Anna Sora,Ginbot,9,2010,34,39,3,76
Oromia,West Arsi,Dodola  Hospital,Meskerem,1,2011,43,9,33,85
Oromia,Ilu Aba Bora,Bure,Sene,10,2011,83,51,97,231
Oromia,East Wellega,Wayu Tuqa,Hedar,3,2010,69,72,91,232
Oromia,West Shewa,Ejersa Lafo,Hamle,11,2010,57,78,34,169
Oromia,Qeleme Wellega,Dale Wabera,Ginbot,9,2010,54,80,98,232
Oromia,Qeleme Wellega,Seyo,Megabit,7,2009,2,16,85,103
Oromia,West Guji,Mkelka Soda,Ginbot,9,2011,31,93,91,215
Oromia,Borena,Dhas,Yekatit,6,2009,1,95,83,179
Oromia,Arsi,Limuna Bilbilo,Teqemt,2,2011,21,73,90,184
Oromia,East Hararge,Fedis,Megabit,7,2009,50,52,11,113
Oromia,West Shewa,Dano,Ginbot,9,2011,95,0,74,169
Oromia,North Shewa,Kuyu Hospital,Sene,10,2010,15,96,10,121
Oromia,Jimma,Shabe,Sene,10,2011,0,6,9,15
Oromia,West Wellega,Begi,Yekatit,6,2009,44,39,31,114
Oromia,West Guji,Dugda Dawa,Sene,10,2010,34,58,73,165
Oromia,Horo Gudru Wellega,Jarte Jardga,Megabit,7,2009,82,74,67,223
Oromia,Ilu Aba Bora,Darimu,Miyazia,8,2011,91,27,77,195
Oromia,Borena,Yabelo,Meskerem,1,2010,52,0,85,137
Oromia,West Shewa,Ginde Beret,Sene,10,2009,21,63,75,159
Oromia,Guji,Adola Reda,Meskerem,1,2011,64,54,11,129
Oromia,East Hararge,Garemuleta Hospital,Megabit,7,2009,82,94,73,249
Oromia,West Arsi,Adaba,Meskerem,1,2011,43,78,88,209
Oromia,East Hararge,Melka Belo,Hamle,11,2010,79,3,59,141
Oromia,Guji,Aga Wayyu,Meskerem,1,2010,63,60,3,126
Oromia,East Hararge,Kumbi,Tir,5,2010,89,45,41,175
Oromia,West Arsi,Gedeb Asasa,Hedar,3,2010,94,77,59,230
Oromia,East Hararge,Goro Muti,Teqemt,2,2011,44,36,5,85
Oromia,Jimma,Guma,Megabit,7,2010,43,73,71,187
Oromia,East Wellega,Guto Gida,Yekatit,6,2009,80,67,9,156
Oromia,Ilu Aba Bora,Bure,Hamle,11,2010,28,17,36,81
Oromia,Bale,Gololcha,Hedar,3,2011,74,68,28,170
Oromia,West Shewa,Tibe Kutaye,Teqemt,2,2010,62,31,38,131
Oromia,West Arsi,Dodola Town,Megabit,7,2010,51,85,57,193
Oromia,Finfine Zuria,Sandefa,Miyazia,8,2011,1,83,79,163
Oromia,East Hararge,Kombolicha,Megabit,7,2010,54,92,56,202
Oromia,Borena,Dhas,Tahesas,4,2011,12,82,88,182
Oromia,Horo Gudru Wellega,Abe Dengoro,Nehase,12,2010,37,3,95,135
Oromia,Horo Gudru Wellega,Jima Rare,Tir,5,2009,77,73,87,237
Oromia,West Wellega,Homa,Sene,10,2010,81,23,65,169
Oromia,Finfine Zuria,Akaki,Yekatit,6,2011,34,40,40,114
Oromia,West Shewa,Midakegni,Megabit,7,2009,71,57,75,203
Oromia,Qeleme Wellega,Gidami Hosp,Ginbot,9,2011,89,86,62,237
Oromia,Guji,Goro Dola,Megabit,7,2010,5,69,22,96
Oromia,South West Shewa,Bantu  Hospital,Hedar,3,2011,48,32,1,81
Oromia,Guji,Liben,Ginbot,9,2009,51,79,52,182
Oromia,West Arsi,Shashemene Rural,Teqemt,2,2011,96,36,27,159
Oromia,East Wellega,Diga,Tir,5,2010,51,84,15,150
Oromia,West Shewa,Midakegni,Megabit,7,2011,54,91,21,166
Oromia,Arsi,Guna,Teqemt,2,2011,30,93,64,187
Oromia,Bale,Goro,Ginbot,9,2009,25,59,41,125
Oromia,West Wellega,Lata Sibu,Hedar,3,2011,18,13,79,110
Oromia,West Wellega,Nejo Rural,Tir,5,2010,93,38,10,141
Oromia,Buno Bedele,Diga,Sene,10,2010,34,59,28,121
Oromia,West Shewa,Ilu Galan,Tahesas,4,2010,47,32,95,174
Oromia,Borena,Yabelo Rural,Nehase,12,2010,26,21,30,77
Oromia,Buno Bedele,Dapho Hana,Miyazia,8,2009,54,33,25,112
Oromia,Finfine Zuria,Akaki,Meskerem,1,2011,73,99,95,267
Oromia,North Shewa,Degem,Tir,5,2011,96,92,79,267
Oromia,South West Shewa,Tole,Ginbot,9,2009,98,15,30,143
Oromia,Buno Bedele,Dapho Hana,Tir,5,2011,6,97,5,108
Oromia,Guji,Dima,Ginbot,9,2011,3,32,68,103
Oromia,Buno Bedele,Dapho Hana,Nehase,12,2010,78,39,0,117
Oromia,Jimma,Limu Kosa,Miyazia,8,2011,22,51,38,111
Oromia,West Wellega,Homa,Sene,10,2010,6,12,97,115
Oromia,East Wellega,Leqa Dulecha,Hamle,11,2010,78,56,64,198
Oromia,East Hararge,Kumbi,Tir,5,2011,69,12,67,148
Oromia,Qeleme Wellega,Jimma Horo,Hamle,11,2009,9,13,29,51
Oromia,West Shewa,Jeldu,Hedar,3,2011,85,38,22,145
Oromia,Guji,Dima,Ginbot,9,2011,6,22,74,102
Oromia,East Shewa,Lomme,Sene,10,2009,94,62,86,242
Oromia,Bale,Berbere,Megabit,7,2010,98,5,44,147
Oromia,West Hararge,Oda Bultum,Tir,5,2010,14,69,57,140
Oromia,Jimma Spe Town,Jimma Spe Town,Sene,10,2009,19,77,15,111
Oromia,South West Shewa,Ameya,Meskerem,1,2010,30,6,60,96
Oromia,Qeleme Wellega,Kake Hosp,Sene,10,2011,82,55,95,232
Oromia,Ilu Aba Bora,Hurumu,Hedar,3,2011,77,99,95,271
Oromia,Finfine Zuria,Sululta Town,Ginbot,9,2011,78,43,75,196
Oromia,West Hararge,Bedesa Town,Yekatit,6,2009,48,12,72,132
Oromia,West Shewa,Adea Berga,Miyazia,8,2011,85,43,14,142
Oromia,West Guji,Abaya,Tir,5,2009,6,33,18,57
Oromia,Guji,Wadara,Ginbot,9,2010,40,22,53,115
Oromia,East Wellega,Limu,Hedar,3,2010,57,41,74,172
Oromia,Jimma,Tiro Afeta,Nehase,12,2009,39,29,95,163
Oromia,Buno Bedele,Dapho Hana,Tir,5,2011,19,74,46,139
Oromia,East Hararge,Kersa Eh,Yekatit,6,2010,26,57,16,99
Oromia,Arsi,Aseko,Ginbot,9,2010,49,93,46,188
Oromia,North Shewa,Wuchale,Hamle,11,2010,17,79,53,149
Oromia,West Wellega,Nejo Hospital,Teqemt,2,2011,73,98,97,268
Oromia,East Hararge,Kumbi,Megabit,7,2010,96,10,33,139
Oromia,Finfine Zuria,Mullo,Sene,10,2010,74,56,88,218
Oromia,Guji,Dima,Tir,5,2010,26,82,57,165
Oromia,West Shewa,Ejersa Lafo,Nehase,12,2010,96,75,27,198
Oromia,Arsi,Ludehetosa,Megabit,7,2011,64,63,63,190
Oromia,East Wellega,Sibu Sire,Nehase,12,2010,26,36,46,108
Oromia,East Wellega,Gobu Seyo,Ginbot,9,2009,45,5,41,91
Oromia,East Hararge,Bedeno,Sene,10,2009,83,97,79,259
Oromia,West Hararge,Hawi Gudina,Hamle,11,2010,82,33,41,156
Oromia,East Hararge,Meta,Yekatit,6,2010,32,50,26,108
Oromia,Bale,Seweyna,Nehase,12,2010,45,40,96,181
Oromia,Guji,Adola Hospital,Sene,10,2011,43,21,78,142
Oromia,Qeleme Wellega,Gidami,Miyazia,8,2011,71,34,91,196
Oromia,Woliso Town,Woliso Town,Megabit,7,2010,78,48,18,144
Oromia,West Hararge,Hawi Gudina,Ginbot,9,2011,23,65,95,183
Oromia,East Hararge,Midega Tole,Hamle,11,2010,3,93,8,104
Oromia,Jimma,Setema,Ginbot,9,2010,52,14,21,87
Oromia,Bale,Sinana,Hamle,11,2010,64,87,66,217
Oromia,West Wellega,Mendi Hospital,Megabit,7,2009,59,2,15,76
Oromia,South West Shewa,Dawo,Miyazia,8,2011,76,80,40,196
Oromia,West Wellega,Nejo Rural,Nehase,12,2010,82,54,41,177
Oromia,South West Shewa,Tulu Bolo Hospital,Nehase,12,2009,24,27,78,129
Oromia,Buno Bedele,Dedesa,Sene,10,2009,52,68,29,149
Oromia,West Shewa,Elifata,Meskerem,1,2011,92,67,60,219
Oromia,West Shewa,Meta Waliqite,Miyazia,8,2009,14,84,68,166
Oromia,Adama Special Town,Adama Town,Megabit,7,2009,47,75,10,132
Oromia,West Wellega,Nole Kaba,Hedar,3,2011,82,63,76,221
Oromia,Bale,Dinsho,Ginbot,9,2011,31,40,42,113
Oromia,Qeleme Wellega,Dambi Dolo Hospital,Megabit,7,2009,1,70,38,109
Oromia,North Shewa,Hidabu Abote,Hedar,3,2010,8,92,36,136
Oromia,East Wellega,Sasiga,Hamle,11,2009,73,80,80,233
Oromia,Ilu Aba Bora,Doreni,Ginbot,9,2010,82,77,11,170
Oromia,West Shewa,Jeldu,Megabit,7,2011,24,45,14,83
Oromia,Assela Town,Assela Town,Hedar,3,2011,65,50,31,146
Oromia,Bale,Gasera,Hamle,11,2010,11,91,28,130
Oromia,West Shewa,Midakegni,Teqemt,2,2011,9,17,34,60
Oromia,East Hararge,Babile Woreda,Hedar,3,2011,83,52,77,212
Oromia,West Arsi,Kokosa,Tir,5,2010,51,69,5,125
Oromia,West Arsi,Kore,Yekatit,6,2011,44,90,25,159
Oromia,Jimma,Mancho,Sene,10,2011,53,57,75,185
Oromia,East Shewa,Adea,Tir,5,2010,80,17,72,169
Oromia,West Shewa,Chelia,Teqemt,2,2010,82,65,29,176
Oromia,Arsi,Ludehetosa,Megabit,7,2009,26,47,21,94
Oromia,East Shewa,Gimbichu,Ginbot,9,2010,86,21,93,200
Oromia,Horo Gudru Wellega,Abe Dengoro,Ginbot,9,2010,47,97,45,189
Oromia,West Guji,Gelana,Tir,5,2009,22,97,49,168
Oromia,West Arsi,Dodola Town,Tir,5,2011,56,43,66,165
Oromia,Horo Gudru Wellega,Abe Dengoro,Ginbot,9,2010,52,87,5,144
Oromia,Horo Gudru Wellega,Shambu Town,Hamle,11,2010,73,88,59,220
Oromia,Arsi,Guna,Yekatit,6,2009,90,2,86,178
Oromia,East Wellega,Leqa Dulecha,Tahesas,4,2011,16,70,6,92
Oromia,South West Shewa,Wonchi,Miyazia,8,2009,39,45,39,123
Oromia,West Guji,Abaya,Sene,10,2009,31,54,27,112
Oromia,Ilu Aba Bora,Halu,Meskerem,1,2011,38,21,78,137
Oromia,Guji,Dima,Hamle,11,2009,18,94,6,118
Oromia,West Guji,Suro Barguda,Nehase,12,2009,86,74,65,225
Oromia,East Hararge,Chinakesen,Hedar,3,2011,19,50,21,90
Oromia,Jimma,Shabe,Miyazia,8,2009,98,8,41,147
Oromia,East Hararge,Gursum,Teqemt,2,2011,89,21,38,148
Oromia,Qeleme Wellega,Jimma Horo,Hamle,11,2009,97,4,62,163
Oromia,Jimma,Dedo,Hamle,11,2010,51,61,32,144
Oromia,Arsi,Amigna,Yekatit,6,2011,7,22,80,109
Oromia,Horo Gudru Wellega,Jarte Jardga,Yekatit,6,2011,88,21,47,156
Oromia,West Hararge,West Harerge	Gumbi Bordede,Meskerem,1,2011,42,93,46,181
Oromia,Arsi,Robe,Ginbot,9,2010,51,37,90,178
Oromia,West Shewa,Ambo,Hedar,3,2011,46,74,5,125
Oromia,Guji,Aga Wayyu,Yekatit,6,2011,42,72,17,131
Oromia,Buno Bedele,Dapho Hana,Hamle,11,2009,23,90,64,177
Oromia,Guji,Gumi Eldallo,Yekatit,6,2009,57,51,82,190
Oromia,West Hararge,Burka Dimtu,Tir,5,2010,88,48,40,176
Oromia,North Shewa,Fiche Hospital,Nehase,12,2009,34,51,77,162
Oromia,Bale,Legehida,Ginbot,9,2009,81,38,15,134
Oromia,East Hararge,Chinakesen,Miyazia,8,2009,67,80,81,228
Oromia,Arsi,Bekoji Town,Miyazia,8,2009,96,63,70,229
Oromia,West Arsi,Kore,Tir,5,2009,6,65,24,95
Oromia,East Wellega,Gida Ayana,Ginbot,9,2011,65,36,89,190
Oromia,East Hararge,Babile,Nehase,12,2010,41,38,66,145
Oromia,East Hararge,Kombolicha,Sene,10,2011,7,33,93,133
Oromia,Arsi,Aseko,Yekatit,6,2010,73,41,46,160
Oromia,Bale,Meda Welabu,Hedar,3,2010,87,35,68,190
Oromia,Jimma Spe Town,Jimma Spe Town,Tir,5,2011,16,9,25,50
Oromia,West Wellega,Kundala,Sene,10,2009,85,76,42,203
Oromia,West Guji,Biebirsa Kojowa,Nehase,12,2009,39,8,79,126
Oromia,Arsi,Aseko,Hedar,3,2011,88,86,96,270
Oromia,South West Shewa,Tulu Bolo Hospital,Tir,5,2011,88,43,25,156
Oromia,West Hararge,Burka Dimtu,Yekatit,6,2011,5,65,73,143
Oromia,East Shewa,Adama,Meskerem,1,2010,91,96,43,230
Oromia,West Arsi,Hebal Arsi,Sene,10,2011,37,35,3,75
Oromia,East Wellega,Sibu Sire,Yekatit,6,2009,75,63,87,225
Oromia,Ilu Aba Bora,Hurumu,Miyazia,8,2009,65,94,3,162
Oromia,Ilu Aba Bora,Algesachi,Megabit,7,2010,11,15,71,97
Oromia,Jimma,Setema,Ginbot,9,2011,47,40,49,136
Oromia,South West Shewa,Kersana Malima,Ginbot,9,2010,9,36,57,102
Oromia,Qeleme Wellega,Gawo Qebe,Sene,10,2010,21,39,74,134
Oromia,Horo Gudru Wellega,Jarte Jardga,Yekatit,6,2010,32,58,32,122
Oromia,Finfine Zuria,Mullo,Miyazia,8,2011,17,99,65,181
Oromia,West Guji,Bule Hora,Megabit,7,2011,31,86,86,203
Oromia,West Guji,Bule Hora,Ginbot,9,2009,6,8,17,31
Oromia,North Shewa,Degem,Ginbot,9,2011,11,24,21,56
Oromia,West Arsi,Adaba,Tir,5,2011,51,67,96,214
Oromia,Jimma,Limu Hospital,Tir,5,2009,87,70,43,200
Oromia,Jimma,Mana,Meskerem,1,2011,11,32,35,78
Oromia,Qeleme Wellega,Laloqile,Megabit,7,2010,98,52,69,219
Oromia,West Hararge,Tulo,Miyazia,8,2011,53,38,83,174
Oromia,Horo Gudru Wellega,Hababo Guduru,Tir,5,2010,98,12,13,123
Oromia,West Shewa,Codi,Sene,10,2009,38,91,81,210
Oromia,West Shewa,Ilu Galan,Teqemt,2,2010,71,88,10,169
Oromia,West Wellega,Homa,Tahesas,4,2010,95,61,95,251
Oromia,Arsi,Gololcha,Megabit,7,2010,34,34,86,154
Oromia,Arsi,Sire,Sene,10,2009,87,68,18,173
Oromia,West Wellega,Kundala,Meskerem,1,2011,58,38,99,195
Oromia,Arsi,Digeluna Tijo,Sene,10,2009,48,67,27,142
Oromia,West Shewa,Guder Hosp,Hamle,11,2009,13,79,28,120
Oromia,East Hararge,Kumbi,Sene,10,2009,1,68,77,146
Oromia,South West Shewa,Becho,Meskerem,1,2010,5,9,27,41
Oromia,West Wellega,Seyo Nole,Hedar,3,2010,15,59,83,157
Oromia,West Hararge,Anchar,Yekatit,6,2009,53,34,24,111
Oromia,West Arsi,Arsi Negele Rural,Ginbot,9,2010,0,85,11,96
Oromia,West Shewa,Ambo Town,Meskerem,1,2010,97,19,10,126
Oromia,Lege Dadi Lege Tafo Town,Lege Dadi Lege Tafo Town,Hamle,11,2010,59,11,84,154
Oromia,Borena,Yabelo Hospital,Sene,10,2009,10,61,88,159
Oromia,North Shewa,Were Jarso,Teqemt,2,2011,93,28,37,158
Oromia,Borena,Moyale,Yekatit,6,2011,6,25,46,77
Oromia,West Wellega,Begi,Miyazia,8,2010,2,76,12,90
Oromia,Dukem Town,Dukem Town,Teqemt,2,2011,93,58,64,215
Oromia,West Wellega,Kundala,Tir,5,2009,74,59,29,162
Oromia,West Hararge,Habro,Megabit,7,2011,96,71,62,229
Oromia,East Wellega,Sasiga,Ginbot,9,2010,39,5,14,58
Oromia,West Arsi,Dodola Rural,Yekatit,6,2010,95,67,67,229
Oromia,West Wellega,Gimbi Public  Hospital,Miyazia,8,2009,0,28,59,87
Oromia,West Wellega,Lata Sibu,Tir,5,2010,94,75,91,260
Oromia,Qeleme Wellega,Dambi Dollo,Megabit,7,2010,91,32,81,204
Oromia,Bale,Sinana,Meskerem,1,2010,60,15,42,117
Oromia,West Guji,Kercha,Tir,5,2011,67,90,97,254
Oromia,West Wellega,Gimbi Public  Hospital,Hedar,3,2010,18,93,70,181
Oromia,Guji,Adola Hospital,Yekatit,6,2010,88,92,91,271
Oromia,East Hararge,Haromaya Hospital,Sene,10,2010,52,93,88,233
Oromia,Arsi,Seru,Nehase,12,2009,59,95,97,251
Oromia,Jimma,Shabe,Meskerem,1,2011,59,12,38,109
Oromia,North Shewa,Abichugna,Yekatit,6,2009,36,43,87,166
Oromia,South West Shewa,Ameya,Nehase,12,2010,74,36,5,115
Oromia,West Guji,Bule Hora Toun,Miyazia,8,2010,84,23,22,129
Oromia,East Hararge,Kersa Eh,Ginbot,9,2010,35,46,20,101
Oromia,West Hararge,Gemechis,Miyazia,8,2009,18,17,46,81
Oromia,East Shewa,Bora,Hedar,3,2011,2,81,88,171
Oromia,Horo Gudru Wellega,Abe Dengoro,Nehase,12,2009,88,90,97,275
Oromia,East Shewa,Lomme,Yekatit,6,2010,1,88,27,116
Oromia,East Shewa,Boset,Hedar,3,2011,42,64,14,120
Oromia,Arsi,Seru,Sene,10,2011,9,25,42,76
Oromia,Bale,Sinana,Yekatit,6,2010,66,43,6,115
Oromia,East Wellega,Nunu Qumba,Hedar,3,2010,91,88,0,179
Oromia,Borena,Meyo,Miyazia,8,2010,50,5,12,67
Oromia,East Wellega,Nunu Qumba,Nehase,12,2010,31,43,24,98
Oromia,Arsi,Aseko,Hedar,3,2010,80,14,67,161
Oromia,Qeleme Wellega,Dale Sedi,Hamle,11,2009,30,20,19,69
Oromia,West Wellega,Babo Gembel,Sene,10,2010,15,43,76,134
Oromia,North Shewa,Debre Libanos,Tir,5,2011,77,36,3,116
Oromia,West Wellega,Lata Sibu,Teqemt,2,2010,53,62,71,186
Oromia,Jimma,Omonada,Yekatit,6,2011,76,19,54,149
Oromia,Robe Town,Robe Town,Teqemt,2,2010,60,46,39,145
Oromia,West Wellega,Boji Cheqorsa,Yekatit,6,2009,50,59,79,188
Oromia,Guji,Negele Hospital,Ginbot,9,2010,21,22,41,84
Oromia,Jimma,Limu Hospital,Nehase,12,2010,79,47,26,152
Oromia,Qeleme Wellega,Dale Wabera,Yekatit,6,2009,17,34,30,81
Oromia,Guji,Girja,Hamle,11,2010,72,21,16,109
Oromia,North Shewa,Girar Jarso,Ginbot,9,2010,27,78,71,176
Oromia,Bale,Arena Buluq,Tir,5,2010,42,43,58,143
Oromia,West Wellega,Mene Sibu,Ginbot,9,2010,7,75,45,127
Oromia,Arsi,Ludehetosa,Miyazia,8,2010,32,66,79,177
Oromia,Qeleme Wellega,Anfilo,Nehase,12,2010,53,63,50,166
Oromia,Bale,Gasera,Miyazia,8,2010,60,48,30,138
Oromia,Finfine Zuria,Sebeta Awas,Meskerem,1,2010,6,36,22,64
Oromia,Ilu Aba Bora,Ale,Ginbot,9,2010,18,15,33,66
Oromia,Ilu Aba Bora,Didu,Meskerem,1,2010,48,42,77,167
Oromia,Jimma,Limu Kosa,Tir,5,2009,11,38,13,62
Oromia,Ilu Aba Bora,Metu Town,Tahesas,4,2010,42,31,75,148
Oromia,Bale,Arena Buluq,Ginbot,9,2009,83,60,70,213
Oromia,Jimma,B/Tolyi,Nehase,12,2010,31,29,44,104
Oromia,Borena,Dire,Megabit,7,2010,36,16,85,137
Oromia,East Hararge,Haromaya Rural,Sene,10,2010,54,14,85,153
Oromia,Borena,Teltele,Tir,5,2009,8,72,1,81
Oromia,Borena,Dilo,Megabit,7,2009,94,0,83,177
Oromia,West Shewa,Ilu Galan,Sene,10,2010,90,0,6,96
Oromia,West Wellega,Gimbi Public  Hospital,Tahesas,4,2010,47,85,36,168
Oromia,West Guji,Bule Hora,Miyazia,8,2010,28,38,24,90
Oromia,Finfine Zuria,Sebeta Awas,Ginbot,9,2009,12,76,14,102
Oromia,East Wellega,Wama Hagelo,Meskerem,1,2011,9,75,86,170
Oromia,West Hararge,Guba Qoricha,Teqemt,2,2010,7,65,44,116
Oromia,East Hararge,Fedis,Tir,5,2010,20,3,52,75
Oromia,West Guji,Suro Barguda,Miyazia,8,2011,77,51,3,131
Oromia,North Shewa,Wuchale,Nehase,12,2009,98,83,77,258
Oromia,Ilu Aba Bora,Algesachi,Teqemt,2,2011,28,73,79,180
Oromia,East Hararge,Babile,Hamle,11,2010,85,5,84,174
Oromia,Borena,Yabelo,Tir,5,2009,32,78,79,189
Oromia,West Hararge,Anchar,Megabit,7,2009,95,64,59,218
Oromia,Jimma,Mana,Yekatit,6,2011,45,93,28,166
Oromia,East Hararge,Chelenko Hospital,Hamle,11,2010,61,8,38,107
Oromia,West Guji,Bule Hora Hospital,Tir,5,2011,3,73,82,158
Oromia,South West Shewa,Sodo Dac'Ha,Teqemt,2,2010,56,62,8,126
Oromia,East Shewa,Dugda,Megabit,7,2010,36,90,89,215
Oromia,East Shewa,Bora,Megabit,7,2010,99,27,45,171
Oromia,East Hararge,Midega Tole,Tir,5,2011,6,51,46,103
Oromia,East Hararge,Melka Belo,Sene,10,2010,56,17,15,88
Oromia,West Wellega,Homa,Tahesas,4,2010,25,22,91,138
Oromia,East Hararge,Chinakesen,Meskerem,1,2011,11,31,10,52
Oromia,West Wellega,Ayira,Sene,10,2010,47,79,60,186
Oromia,Burayu Town,Burayu Town,Megabit,7,2010,9,76,60,145
Oromia,Guji,Adola Hospital,Teqemt,2,2011,68,42,99,209
Oromia,East Shewa,Olanciti Hospital,Megabit,7,2009,90,62,43,195
Oromia,East Shewa,Matahara,Meskerem,1,2011,8,8,52,68
Oromia,Arsi,Tena,Ginbot,9,2010,41,11,60,112
Oromia,West Wellega,Nejo Hospital,Hedar,3,2011,46,93,64,203
Oromia,Arsi,Digeluna Tijo,Megabit,7,2011,41,7,79,127
Oromia,Ilu Aba Bora,Didu,Tahesas,4,2011,61,60,2,123
Oromia,West Guji,Gelana,Meskerem,1,2011,86,31,49,166
Oromia,Buno Bedele,Diga,Tir,5,2011,5,27,61,93
Oromia,West Arsi,Dodola Town,Yekatit,6,2010,26,1,86,113
Oromia,West Wellega,Boji Cheqorsa,Tir,5,2011,96,86,0,182
Oromia,Arsi,Dodota,Yekatit,6,2010,50,6,74,130
Oromia,Guji,Gumi Eldallo,Megabit,7,2010,72,89,64,225
Oromia,Jimma,Gomma,Teqemt,2,2010,39,1,31,71
Oromia,Jimma,Sekoru,Hamle,11,2009,23,43,96,162
Oromia,Guji,Bore,Tir,5,2011,44,47,35,126
Oromia,Horo Gudru Wellega,Horo,Tir,5,2010,10,73,18,101
Oromia,Arsi,Shirka,Yekatit,6,2011,38,97,57,192
Oromia,Arsi,Seru,Sene,10,2010,45,29,85,159
Oromia,East Wellega,Ebantu,Yekatit,6,2010,81,19,25,125
Oromia,West Shewa,Gojo Hospital,Hamle,11,2010,72,8,65,145
Oromia,South West Shewa,Kersana Malima,Nehase,12,2010,62,74,96,232
Oromia,West Shewa,Dano,Megabit,7,2009,87,49,90,226
Oromia,West Shewa,Gedo Hospital,Yekatit,6,2009,98,93,23,214
Oromia,East Hararge,Haromaya Hospital,Tahesas,4,2010,43,95,29,167
Oromia,Buno Bedele,Chewaqa,Ginbot,9,2011,54,81,50,185
Oromia,Buno Bedele,Dapho Hana,Meskerem,1,2011,54,84,24,162
Oromia,West Arsi,Gedeb Asasa,Ginbot,9,2009,23,66,65,154
Oromia,Arsi,Gololcha,Meskerem,1,2010,23,49,11,83
Oromia,Arsi,Munesa,Tahesas,4,2011,53,56,71,180
Oromia,Horo Gudru Wellega,Jima Geneti,Megabit,7,2011,46,52,32,130
Oromia,East Shewa,Fentale,Sene,10,2011,28,70,20,118
Oromia,Borena,Yabelo Hospital,Megabit,7,2009,51,85,26,162
Oromia,West Wellega,Haru,Sene,10,2011,40,5,86,131
Oromia,West Shewa,Ejersa Lafo,Miyazia,8,2010,65,7,72,144
Oromia,Qeleme Wellega,Hawa Gelan,Yekatit,6,2009,24,47,22,93
Oromia,West Wellega,Homa,Sene,10,2010,88,25,30,143
Oromia,Guji,Hambela Wamena,Teqemt,2,2011,10,75,13,98
Oromia,Guji,Aga Wayyu,Megabit,7,2009,85,94,4,183
Oromia,East Wellega,Guto Gida,Hamle,11,2010,78,63,43,184
Oromia,Qeleme Wellega,Seyo,Hamle,11,2009,97,54,34,185
Oromia,East Wellega,Nunu Qumba,Hamle,11,2009,0,28,75,103
Oromia,Guji,Odo Shakiso,Tahesas,4,2010,27,86,44,157
Oromia,Nekemte Town,Nekemte Town,Megabit,7,2010,75,65,28,168
Oromia,North Shewa,Kimbibit,Miyazia,8,2011,24,16,61,101
Oromia,Borena,Dubluk,Sene,10,2009,6,87,87,180
Oromia,East Hararge,Haromaya Hospital,Tir,5,2009,6,57,90,153
Oromia,Jimma Spe Town,Jimma Spe Town,Megabit,7,2009,8,75,14,97
Oromia,West Shewa,Metarobi,Hedar,3,2011,44,35,70,149
Oromia,Burayu Town,Burayu Town,Tahesas,4,2010,16,76,92,184
Oromia,West Wellega,Jarso,Yekatit,6,2010,69,59,72,200
Oromia,East Hararge,Kurfa Chele,Tir,5,2011,26,2,49,77
Oromia,Qeleme Wellega,Dale Wabera,Miyazia,8,2009,46,30,96,172
Oromia,South West Shewa,Bantu  Hospital,Tir,5,2011,12,4,91,107
Oromia,Borena,Yabelo Hospital,Ginbot,9,2010,23,63,65,151
Oromia,Buno Bedele,Chora,Miyazia,8,2009,26,95,14,135
Oromia,Finfine Zuria,Akaki,Hedar,3,2011,73,9,39,121
Oromia,North Shewa,Jido,Meskerem,1,2011,4,85,88,177
Oromia,Arsi,Jeju,Tahesas,4,2010,78,35,8,121
Oromia,Qeleme Wellega,Dale Sedi,Teqemt,2,2011,57,31,81,169
Oromia,Borena,Moyale,Ginbot,9,2010,98,14,34,146
Oromia,Arsi,Amigna,Tahesas,4,2010,6,34,70,110
Oromia,West Wellega,Begi Hospital,Yekatit,6,2009,71,76,0,147
Oromia,East Shewa,Liben,Miyazia,8,2010,57,36,50,143
Oromia,Finfine Zuria,Sebeta Awas,Yekatit,6,2009,15,95,50,160
Oromia,Buno Bedele,Bedele Town,Tahesas,4,2010,53,47,22,122
Oromia,West Shewa,Jeldu,Tir,5,2011,87,54,99,240
Oromia,Guji,Bore,Tahesas,4,2010,72,72,96,240
Oromia,Borena,Yabelo Hospital,Hedar,3,2011,70,21,55,146
Oromia,Borena,Dilo,Megabit,7,2010,4,77,89,170
Oromia,Qeleme Wellega,Hawa Gelan,Meskerem,1,2010,0,84,57,141
Oromia,East Wellega,Nunu Qumba,Megabit,7,2011,17,89,97,203
Oromia,West Guji,Bule Hora,Tir,5,2010,12,85,12,109
Oromia,West Wellega,Guliso,Sene,10,2009,50,30,81,161
Oromia,West Hararge,Daro Lebu,Megabit,7,2010,61,5,5,71
Oromia,West Wellega,Homa,Nehase,12,2009,77,47,93,217
Oromia,Qeleme Wellega,Gidami,Ginbot,9,2010,29,77,92,198
Oromia,West Shewa,Metarobi,Megabit,7,2009,13,65,10,88
Oromia,Ilu Aba Bora,Becho,Miyazia,8,2009,41,23,57,121
Oromia,South West Shewa,Ameya,Tir,5,2009,1,66,31,98
Oromia,Horo Gudru Wellega,Horo,Tahesas,4,2011,99,66,49,214
Oromia,Qeleme Wellega,Jimma Horo,Tir,5,2011,63,70,74,207
Oromia,West Wellega,Babo Gembel,Tahesas,4,2010,96,66,40,202
Oromia,East Wellega,Gobu Seyo,Megabit,7,2009,94,6,36,136
Oromia,Bale,Gololcha,Tir,5,2010,77,93,79,249
Oromia,Bale,Gololcha,Megabit,7,2010,47,96,1,144
Oromia,East Wellega,Wayu Tuqa,Ginbot,9,2009,93,17,76,186
Oromia,Bale,Gasera,Tahesas,4,2011,65,33,16,114
Oromia,West Hararge,Anchar,Ginbot,9,2011,43,23,73,139
Oromia,Arsi,Tena,Yekatit,6,2011,35,51,57,143
Oromia,Borena,Yabelo Rural,Ginbot,9,2009,62,46,32,140
Oromia,Ilu Aba Bora,Metu Town,Hedar,3,2010,40,75,14,129
Oromia,West Wellega,Ayira,Tahesas,4,2010,56,57,31,144
Oromia,West Hararge,Chiro Hospital,Miyazia,8,2009,46,39,86,171
Oromia,Ilu Aba Bora,Yayu,Meskerem,1,2010,83,51,86,220
Oromia,East Shewa,Adama,Megabit,7,2009,36,69,80,185
Oromia,Guji,Hambela Wamena,Yekatit,6,2011,90,94,42,226
Oromia,West Wellega,Yubdo,Hedar,3,2011,60,57,85,202
Oromia,East Hararge,Kersa Eh,Hamle,11,2009,65,94,55,214
Oromia,South West Shewa,Wonchi,Miyazia,8,2010,74,36,3,113
Oromia,East Hararge,Haromaya Town,Miyazia,8,2009,43,47,20,110
Oromia,East Shewa,Lomme,Sene,10,2010,19,99,38,156
Oromia,Lege Dadi Lege Tafo Town,Lege Dadi Lege Tafo Town,Yekatit,6,2011,25,94,55,174
Oromia,East Hararge,Meta,Ginbot,9,2009,90,98,19,207
Oromia,West Wellega,Mendi Hospital,Ginbot,9,2011,54,67,76,197
Oromia,Buno Bedele,Dedesa,Tahesas,4,2010,32,87,14,133
Oromia,Horo Gudru Wellega,Amuru,Tir,5,2011,10,36,47,93
Oromia,Guji,Gumi Eldallo,Miyazia,8,2011,89,74,42,205
Oromia,West Shewa,Jibat,Megabit,7,2011,98,97,43,238
Oromia,Qeleme Wellega,Yemalogi Wolel,Sene,10,2010,76,2,56,134
Oromia,Adama Special Town,Adama Town,Teqemt,2,2011,84,33,36,153
Oromia,Qeleme Wellega,Laloqile,Nehase,12,2010,7,69,33,109
Oromia,Jimma,Mancho,Yekatit,6,2010,70,4,31,105
Oromia,West Wellega,Mendi Town,Nehase,12,2010,50,78,56,184
Oromia,Arsi,Deksis,Miyazia,8,2011,58,49,5,112
Oromia,West Shewa,Inchini Hospital,Teqemt,2,2011,68,31,14,113
Oromia,Sebeta Town,Sebeta Town,Meskerem,1,2011,2,87,19,108
Oromia,East Hararge,Bedeno,Tir,5,2011,10,3,57,70
Oromia,West Shewa,Jeldu,Hedar,3,2010,75,42,0,117
Oromia,Guji,Gumi Eldallo,Yekatit,6,2010,65,40,54,159
Oromia,Qeleme Wellega,Seyo,Hamle,11,2010,16,96,42,154
Oromia,Arsi,Munesa,Megabit,7,2009,22,98,23,143
Oromia,West Arsi,Shashemene Rural,Yekatit,6,2010,59,91,29,179
Oromia,Borena,Dubluk,Miyazia,8,2011,32,81,70,183
Oromia,Horo Gudru Wellega,Jima Geneti,Nehase,12,2010,65,33,29,127
Oromia,Guji,Bore,Teqemt,2,2011,47,9,43,99
Oromia,Qeleme Wellega,Dale Sedi,Megabit,7,2009,97,0,27,124
Oromia,Ilu Aba Bora,Hurumu,Sene,10,2010,30,41,59,130
Oromia,East Wellega,Guto Gida,Yekatit,6,2009,48,93,97,238
Oromia,East Hararge,Aweday Town,Miyazia,8,2009,83,60,17,160
Oromia,North Shewa,Aleiltu,Tir,5,2010,75,79,7,161
Oromia,East Shewa,Dugda,Nehase,12,2010,75,39,68,182
Oromia,East Hararge,Jarso,Nehase,12,2009,38,3,53,94
Oromia,West Wellega,Ayira,Yekatit,6,2010,79,38,87,204
Oromia,North Shewa,Jido,Megabit,7,2009,93,2,34,129
Oromia,Arsi,Enkelo Wabe,Hedar,3,2010,47,65,76,188
Oromia,Horo Gudru Wellega,Abe Dengoro,Hedar,3,2010,67,46,98,211
Oromia,Borena,El Way,Nehase,12,2010,34,93,39,166
Oromia,Horo Gudru Wellega,Jima Geneti,Tir,5,2011,83,19,50,152
Oromia,Borena,Gomole,Tir,5,2011,31,56,9,96
Oromia,West Shewa,Tikur Enchini,Meskerem,1,2010,19,58,19,96
Oromia,East Hararge,Babile Woreda,Nehase,12,2009,40,11,71,122
Oromia,West Arsi,Shala,Tahesas,4,2011,99,62,26,187
Oromia,Sebeta Town,Sebeta Town,Sene,10,2009,65,94,50,209
Oromia,West Wellega,Boji Dermeji,Tahesas,4,2010,5,8,79,92
Oromia,North Shewa,Aleiltu,Meskerem,1,2011,50,33,31,114
Oromia,Qeleme Wellega,Dambi Dollo,Miyazia,8,2009,41,77,41,159
Oromia,Borena,Wachile,Miyazia,8,2011,80,87,45,212
Oromia,West Hararge,Habro,Teqemt,2,2011,94,68,15,177
Oromia,Jimma,Chora Boter,Nehase,12,2009,30,58,61,149
Oromia,West Wellega,Homa,Miyazia,8,2010,17,21,21,59
Oromia,Arsi,Enkelo Wabe,Miyazia,8,2010,91,63,69,223
Oromia,West Shewa,Liban Jawi,Tir,5,2010,44,26,27,97
Oromia,West Hararge,Chiro Town,Nehase,12,2010,69,83,90,242
Oromia,West Arsi,Gedeb Asasa,Teqemt,2,2011,87,85,28,200
Oromia,Arsi,Ludehetosa,Nehase,12,2010,54,5,74,133
Oromia,West Arsi,Gambo Hospital,Sene,10,2010,25,20,97,142
Oromia,Ilu Aba Bora,Halu,Sene,10,2011,23,14,44,81
Oromia,Arsi,Robe,Meskerem,1,2011,17,38,87,142
Oromia,Ilu Aba Bora,Metu Town,Tir,5,2011,24,42,13,79
Oromia,Guji,Goro Dola,Megabit,7,2011,76,88,14,178
Oromia,West Wellega,Gimbi Rural,Yekatit,6,2011,17,45,19,81
Oromia,Ilu Aba Bora,Yayu,Tahesas,4,2010,45,1,30,76
Oromia,West Hararge,Guba Qoricha,Nehase,12,2009,70,61,74,205
Oromia,Qeleme Wellega,Dambi Dolo Hospital,Nehase,12,2010,82,92,92,266
Oromia,Guji,Girja,Megabit,7,2009,28,85,98,211
Oromia,North Shewa,Degem,Nehase,12,2009,59,45,18,122
Oromia,West Shewa,Ginde Beret,Nehase,12,2009,16,42,74,132
Oromia,Jimma,Omo Nada Hospital,Miyazia,8,2011,47,2,73,122
Oromia,East Hararge,Deder,Hamle,11,2009,33,95,16,144
Oromia,Woliso Town,Woliso Town,Ginbot,9,2011,34,33,0,67
Oromia,Ilu Aba Bora,Nono Sele,Tahesas,4,2011,11,77,19,107
Oromia,Arsi,Aseko,Nehase,12,2009,92,76,16,184
Oromia,South West Shewa,Woliso Town,Nehase,12,2009,50,16,96,162
Oromia,West Shewa,Ejersa Lafo,Ginbot,9,2010,3,10,42,55
Oromia,East Wellega,Kiremu,Tir,5,2011,4,54,24,82
Oromia,West Wellega,Genji,Ginbot,9,2011,18,50,34,102
Oromia,West Hararge,Oda Bultum,Ginbot,9,2009,4,30,39,73
Oromia,Bale,Agarfa,Hamle,11,2009,72,71,92,235
Oromia,South West Shewa,Tole,Meskerem,1,2010,59,76,21,156
Oromia,South West Shewa,Kersana Malima,Hamle,11,2009,43,64,14,121
Oromia,East Hararge,Fedis,Hamle,11,2010,83,29,30,142
Oromia,Bale,Seweyna,Yekatit,6,2009,89,58,46,193
Oromia,West Shewa,Inchini Hospital,Megabit,7,2010,93,30,0,123
Oromia,Qeleme Wellega,Hawa Gelan,Yekatit,6,2011,25,63,20,108
Oromia,West Shewa,Ambo Hospital,Yekatit,6,2009,74,36,79,189
Oromia,Arsi,Bale Gesgara,Yekatit,6,2009,0,50,3,53
Oromia,Buno Bedele,Bedele Zuriya,Nehase,12,2010,49,37,30,116
Oromia,Jimma,Kersa,Miyazia,8,2010,37,37,86,160
Oromia,East Wellega,Gudeyabila,Miyazia,8,2011,77,5,51,133
Oromia,East Wellega,Guto Gida,Ginbot,9,2010,35,37,82,154
Oromia,Bale,Ginir Town,Tahesas,4,2011,36,61,55,152
Oromia,East Hararge,Haromaya Hospital,Megabit,7,2009,93,17,35,145
Oromia,West Shewa,Ginde Beret,Nehase,12,2010,82,10,28,120
Oromia,Ilu Aba Bora,Bure,Tir,5,2010,50,64,61,175
Oromia,Bale,Dawe Qachen,Tahesas,4,2010,13,77,89,179
Oromia,Guji,Bore,Ginbot,9,2011,67,76,3,146
Oromia,East Shewa,Olanciti Hospital,Ginbot,9,2010,94,7,74,175
Oromia,East Hararge,Chelenko Hospital,Teqemt,2,2010,47,69,42,158
Oromia,Jimma,Omonada,Tir,5,2011,69,6,70,145
Oromia,Qeleme Wellega,Dale Wabera,Sene,10,2009,23,87,69,179
Oromia,Arsi,Guna,Tir,5,2010,84,3,59,146
Oromia,Borena,Moyale Hospital,Teqemt,2,2011,8,91,9,108
Oromia,East Hararge,Deder,Tir,5,2011,18,86,55,159
Oromia,North Shewa,Yaya Gulele,Tir,5,2011,49,20,50,119
Oromia,Horo Gudru Wellega,Shambu Hospital,Yekatit,6,2010,99,42,58,199
Oromia,West Arsi,Hebal Arsi,Hamle,11,2010,9,63,51,123
Oromia,Guji,Saba Boru,Yekatit,6,2010,24,98,67,189
Oromia,Bale,Delo Mena,Megabit,7,2009,69,33,15,117
Oromia,Borena,Yabelo,Miyazia,8,2010,16,4,30,50
Oromia,East Shewa,Bora,Sene,10,2010,0,11,33,44
Oromia,East Hararge,Haromaya Hospital,Miyazia,8,2009,96,6,52,154
Oromia,Jimma,Tiro Afeta,Meskerem,1,2010,13,47,29,89
Oromia,West Guji,Kercha,Tir,5,2011,23,12,27,62
Oromia,Bale,Robe Town,Yekatit,6,2009,15,32,54,101
Oromia,North Shewa,Degem,Teqemt,2,2010,32,43,30,105
Oromia,Arsi,Gololcha,Megabit,7,2009,94,31,49,174
Oromia,North Shewa,Yaya Gulele,Meskerem,1,2011,36,90,77,203
Oromia,Borena,Arero,Yekatit,6,2011,64,17,2,83
Oromia,East Hararge,Deder,Sene,10,2009,12,37,26,75
Oromia,East Wellega,Limu,Yekatit,6,2010,55,50,2,107
Oromia,Jimma,Setema,Teqemt,2,2010,48,2,53,103
Oromia,Guji,Saba Boru,Yekatit,6,2009,44,9,20,73
Oromia,South West Shewa,Ilu,Tahesas,4,2011,39,59,91,189
Oromia,Qeleme Wellega,Laloqile,Yekatit,6,2009,17,2,67,86
Oromia,Arsi,Ludehetosa,Nehase,12,2009,77,38,94,209
Oromia,West Guji,Kercha Hospital,Hedar,3,2010,31,69,98,198
Oromia,Finfine Zuria,Holeta,Megabit,7,2009,71,67,51,189
Oromia,Arsi,Bale Gesgara,Megabit,7,2009,9,10,4,23
Oromia,West Hararge,Hawi Gudina,Ginbot,9,2010,17,73,30,120
Oromia,Guji,Hambela Wamena,Meskerem,1,2010,98,80,12,190
Oromia,Guji,Negele Town,Yekatit,6,2011,13,52,23,88
Oromia,Jimma,Guma,Tahesas,4,2011,94,78,4,176
Oromia,Arsi,Shirka,Yekatit,6,2010,62,5,28,95
Oromia,East Wellega,Sibu Sire,Miyazia,8,2009,11,62,85,158
Oromia,West Wellega,Qiltu Kara,Tir,5,2009,10,30,45,85
Oromia,West Wellega,Lata Sibu,Ginbot,9,2011,1,96,45,142
Oromia,East Hararge,Deder,Sene,10,2009,42,69,74,185
Oromia,Ilu Aba Bora,Darimu,Tahesas,4,2010,87,63,20,170
Oromia,Sululta Town,Sululta Town,Ginbot,9,2010,52,36,34,122
Oromia,Arsi,Sire,Sene,10,2010,23,7,84,114
Oromia,Bale,Seweyna,Tahesas,4,2010,32,97,76,205
Oromia,Arsi,Digeluna Tijo,Ginbot,9,2011,89,95,18,202
Oromia,Finfine Zuria,Sandefa,Sene,10,2011,17,2,91,110
Oromia,East Hararge,Kurfa Chele,Tir,5,2011,56,37,83,176
Oromia,Bale,Meda Welabu,Ginbot,9,2011,78,74,85,237
Oromia,East Wellega,Sasiga,Nehase,12,2009,30,41,10,81
Oromia,Assela Town,Assela Town,Tahesas,4,2011,57,8,82,147
Oromia,Arsi,Bekoji Town,Tir,5,2011,71,11,54,136
Oromia,Guji,Shakiso Town,Tir,5,2010,92,62,15,169
Oromia,East Hararge,Haromaya Hospital,Nehase,12,2010,23,55,26,104
Oromia,Guji,Liben,Nehase,12,2010,64,44,25,133
Oromia,Dukem Town,Dukem Town,Tir,5,2011,11,80,1,92
Oromia,West Wellega,Mene Sibu,Hedar,3,2011,7,50,45,102
Oromia,East Hararge,Goro Gutu,Yekatit,6,2010,36,24,58,118
Oromia,East Hararge,Babile Woreda,Yekatit,6,2011,15,28,31,74
Oromia,Horo Gudru Wellega,Abay Chomen,Teqemt,2,2010,75,92,39,206
Oromia,East Shewa,Gimbichu,Tir,5,2010,56,2,73,131
Oromia,East Shewa,Lomme,Megabit,7,2011,93,98,28,219
Oromia,West Hararge,Daro Lebu,Hedar,3,2011,53,85,49,187
Oromia,West Guji,Biebirsa Kojowa,Yekatit,6,2010,77,6,21,104
Oromia,West Wellega,Lata Sibu,Miyazia,8,2010,19,97,53,169
Oromia,Arsi,Amigna,Tir,5,2011,32,38,12,82
Oromia,Guji,Adola Town,Tir,5,2010,87,60,74,221
Oromia,Arsi,Digeluna Tijo,Tir,5,2009,60,7,78,145
Oromia,Borena,Dhas,Sene,10,2009,77,85,59,221
Oromia,West Arsi,Kokosa,Megabit,7,2009,63,71,22,156
Oromia,South West Shewa,St.Luke Hospital,Ginbot,9,2010,42,69,59,170
Oromia,Borena,Moyale,Meskerem,1,2011,22,10,98,130
Oromia,West Wellega,Boji Cheqorsa,Yekatit,6,2010,69,20,66,155
Oromia,South West Shewa,Ilu,Tir,5,2010,31,28,3,62
Oromia,Bishoftu Town,Bishoftu Town,Tir,5,2011,99,83,77,259
Oromia,East Wellega,Kiremu,Teqemt,2,2011,55,35,19,109
Oromia,Buno Bedele,Diga,Hedar,3,2011,79,33,12,124
Oromia,West Guji,Bule Hora Hospital,Megabit,7,2010,23,12,92,127
Oromia,West Hararge,Chiro Hospital,Nehase,12,2009,43,25,41,109
Oromia,Ilu Aba Bora,Doreni,Meskerem,1,2011,75,23,23,121
Oromia,Bale,Seweyna,Meskerem,1,2011,81,1,6,88
Oromia,West Hararge,Oda Bultum,Yekatit,6,2010,63,37,25,125
Oromia,East Shewa,Olanciti Hospital,Megabit,7,2011,23,12,80,115
Oromia,West Shewa,Ambo Hospital,Megabit,7,2010,51,66,97,214
Oromia,Bale,Gololcha,Teqemt,2,2010,41,63,2,106
Oromia,West Wellega,Boji Cheqorsa,Tahesas,4,2011,16,78,29,123
Oromia,Arsi,Enkelo Wabe,Meskerem,1,2010,43,35,24,102
Oromia,Jimma,Limu Hospital,Hedar,3,2011,54,60,98,212
Oromia,Buno Bedele,Chewaqa,Teqemt,2,2011,48,20,7,75
Oromia,Jimma,Kersa,Teqemt,2,2010,76,79,65,220
Oromia,Horo Gudru Wellega,Horro Buluk,Hedar,3,2010,34,35,66,135
Oromia,Jimma,Gera,Miyazia,8,2009,3,9,40,52
Oromia,Qeleme Wellega,Gidami,Miyazia,8,2011,34,28,7,69
Oromia,Jimma,Mana,Tahesas,4,2011,78,25,53,156
Oromia,Guji,Goro Dola,Miyazia,8,2011,3,85,21,109
Oromia,West Wellega,Boji Cheqorsa,Tir,5,2009,49,98,49,196
Oromia,Arsi,Bale Gesgara,Megabit,7,2009,52,80,20,152
Oromia,North Shewa,Dera Hospital,Sene,10,2010,9,34,15,58
Oromia,Jimma,Gomma,Ginbot,9,2009,22,56,76,154
Oromia,East Hararge,Kurfa Chele,Megabit,7,2010,91,81,11,183
Oromia,West Arsi,Kofele,Megabit,7,2009,45,65,34,144
Oromia,Ilu Aba Bora,Metu Town,Miyazia,8,2009,12,48,86,146
Oromia,East Wellega,Gudeyabila,Nehase,12,2010,45,75,49,169
Oromia,Guji,Goro Dola,Megabit,7,2009,71,23,76,170
Oromia,Jimma,Gomma,Yekatit,6,2009,33,50,51,134
Oromia,Arsi,Munesa,Megabit,7,2009,90,59,97,246
Oromia,Qeleme Wellega,Gawo Qebe,Miyazia,8,2010,74,23,40,137
Oromia,Horo Gudru Wellega,Horro Buluk,Miyazia,8,2011,27,14,32,73
Oromia,South West Shewa,Becho,Ginbot,9,2011,23,68,71,162
Oromia,North Shewa,Abichugna,Teqemt,2,2011,23,46,35,104
Oromia,Borena,Dubluk,Sene,10,2009,27,13,53,93
Oromia,Holeta Town,Holeta Town,Tahesas,4,2010,31,9,62,102
Oromia,Ilu Aba Bora,Algesachi,Nehase,12,2009,93,76,37,206
Oromia,West Arsi,Dodola Rural,Sene,10,2011,61,30,18,109
Oromia,East Hararge,Babile,Tir,5,2011,93,65,52,210
Oromia,Finfine Zuria,Berreh,Sene,10,2011,28,19,80,127
Oromia,Qeleme Wellega,Jimma Horo,Sene,10,2011,45,85,48,178
Oromia,Borena,Gomole,Sene,10,2010,65,0,75,140
Oromia,West Wellega,Nejo Rural,Miyazia,8,2010,76,17,20,113
Oromia,West Hararge,Chiro Zuriya,Hamle,11,2009,27,41,50,118
Oromia,Jimma,Tiro Afeta,Tir,5,2009,94,31,64,189
Oromia,West Wellega,Gimbi Public  Hospital,Teqemt,2,2011,65,67,4,136
Oromia,West Guji,Bule Hora Toun,Megabit,7,2010,35,64,59,158
Oromia,Arsi,Shirka,Yekatit,6,2009,97,77,68,242
Oromia,Horo Gudru Wellega,Horro Buluk,Ginbot,9,2011,82,35,20,137
Oromia,East Hararge,Gole Oda,Miyazia,8,2011,90,36,97,223
Oromia,Arsi,Seru,Teqemt,2,2011,63,19,76,158
Oromia,East Wellega,Limu,Nehase,12,2009,88,69,59,216
Oromia,Qeleme Wellega,Seyo,Hedar,3,2010,81,92,91,264
Oromia,West Arsi,Shashemene Rural,Hedar,3,2011,1,84,61,146
Oromia,Qeleme Wellega,Gidami Hosp,Tahesas,4,2011,78,53,9,140
Oromia,Finfine Zuria,Holeta,Meskerem,1,2010,37,43,54,134
Oromia,East Hararge,Chinakesen,Hamle,11,2010,23,39,18,80
Oromia,West Wellega,Babo Gembel,Teqemt,2,2011,17,58,62,137
Oromia,Guji,Girja,Tir,5,2009,37,12,88,137
Oromia,East Hararge,Deder Hospital,Teqemt,2,2010,61,99,14,174
Oromia,South West Shewa,Seden Sodo,Megabit,7,2010,94,7,75,176
Oromia,Arsi,Digeluna Tijo,Meskerem,1,2011,27,0,75,102
Oromia,East Hararge,Bisidimo Hospital,Miyazia,8,2009,36,94,4,134
Oromia,East Wellega,Sibu Sire,Ginbot,9,2010,14,0,24,38
Oromia,West Shewa,Gindeberet Hospital,Megabit,7,2011,84,19,3,106
Oromia,West Shewa,Meta Waliqite,Nehase,12,2009,5,78,47,130
Oromia,Borena,Moyale,Sene,10,2009,72,83,52,207
Oromia,East Hararge,Bisidimo Hospital,Meskerem,1,2010,32,73,77,182
Oromia,West Guji,Bule Hora Toun,Sene,10,2011,77,38,61,176
Oromia,East Wellega,Jimma Arjo,Megabit,7,2010,93,79,34,206
Oromia,West Wellega,Seyo Nole,Tahesas,4,2010,29,90,91,210
Oromia,East Wellega,Sibu Sire,Tir,5,2009,55,89,48,192
Oromia,Bale,Ginir Town,Teqemt,2,2010,8,69,37,114
Oromia,Borena,Arero,Ginbot,9,2010,65,95,12,172
Oromia,West Arsi,Kofele,Miyazia,8,2011,86,35,92,213
Oromia,Bale,Meda Welabu,Hedar,3,2011,87,80,95,262
Oromia,Arsi,Bale Gesgara,Tahesas,4,2010,14,65,46,125
Oromia,Lege Dadi Lege Tafo Town,Lege Dadi Lege Tafo Town,Yekatit,6,2009,89,57,42,188
Oromia,Bale,Dawe Qachen,Teqemt,2,2011,59,97,8,164
Oromia,North Shewa,Hidabu Abote,Tir,5,2010,77,48,54,179
Oromia,Guji,Bore Hospital,Teqemt,2,2011,57,77,35,169
Oromia,West Arsi,Dodola Rural,Yekatit,6,2011,13,79,77,169
Oromia,East Wellega,Sasiga,Tir,5,2009,6,69,26,101
Oromia,Ilu Aba Bora,Darimu,Teqemt,2,2011,19,92,39,150
Oromia,Arsi,Amigna,Sene,10,2009,57,62,25,144
Oromia,North Shewa,Yaya Gulele,Teqemt,2,2011,41,84,74,199
Oromia,West Wellega,Mene Sibu,Ginbot,9,2010,79,57,90,226
Oromia,Horo Gudru Wellega,Abay Chomen,Hamle,11,2009,77,76,83,236
Oromia,Horo Gudru Wellega,Jarte Jardga,Tir,5,2009,26,71,32,129
Oromia,West Wellega,Boji Dermeji,Hedar,3,2010,90,82,64,236
Oromia,Jimma,Omonada,Hedar,3,2011,29,74,50,153
Oromia,West Wellega,Gimbi Adventist Hospital,Hamle,11,2010,74,7,19,100
Oromia,Horo Gudru Wellega,Abay Chomen,Nehase,12,2010,20,53,62,135
Oromia,West Arsi,Gambo Hospital,Sene,10,2009,56,61,74,191
Oromia,Arsi,Bale Gesgara,Ginbot,9,2009,27,32,2,61
Oromia,West Wellega,Lalo Asabi,Megabit,7,2011,85,90,19,194
Oromia,West Guji,Suro Barguda,Hamle,11,2010,38,30,83,151
Oromia,West Guji,Bule Hora,Yekatit,6,2010,67,44,29,140
Oromia,South West Shewa,Wonchi,Miyazia,8,2011,79,87,6,172
Oromia,West Wellega,Mene Sibu,Ginbot,9,2009,28,93,77,198
Oromia,Guji,Goro Dola,Nehase,12,2009,9,21,94,124
Oromia,West Wellega,Qiltu Kara,Teqemt,2,2011,9,35,55,99
Oromia,North Shewa,Fichetown,Tir,5,2011,82,0,73,155
Oromia,West Arsi,Dodola  Hospital,Teqemt,2,2011,18,99,66,183
Oromia,West Arsi,Adaba,Tir,5,2010,21,43,84,148
Oromia,West Wellega,Lata Sibu,Hamle,11,2009,30,31,67,128
Oromia,West Hararge,Chiro Hospital,Megabit,7,2010,92,53,94,239
Oromia,West Arsi,Shashemene Rural,Hamle,11,2010,29,19,56,104
Oromia,East Hararge,Gursum,Teqemt,2,2010,27,38,70,135
Oromia,East Hararge,Chinakesen,Yekatit,6,2009,27,73,64,164
Oromia,West Wellega,Haru,Meskerem,1,2010,39,94,37,170
Oromia,Shashamane Town,Shashamane Town,Tir,5,2011,15,40,31,86
Oromia,West Shewa,Adea Berga,Sene,10,2009,53,85,34,172
Oromia,Jimma,Tiro Afeta,Sene,10,2011,98,85,37,220
Oromia,North Shewa,Yaya Gulele,Meskerem,1,2011,86,10,80,176
Oromia,Arsi,Deksis,Megabit,7,2009,84,93,55,232
Oromia,West Shewa,Ambo Hospital,Hamle,11,2010,49,97,5,151
Oromia,West Wellega,Begi,Teqemt,2,2010,72,38,49,159
Oromia,East Wellega,Gida Ayana,Yekatit,6,2009,83,86,83,252
Oromia,West Wellega,Nejo Rural,Miyazia,8,2011,81,96,87,264
Oromia,Guji,Negele Town,Tahesas,4,2011,10,74,85,169
Oromia,East Wellega,Kiremu,Sene,10,2010,87,34,46,167
Oromia,East Hararge,Bisidimo Hospital,Megabit,7,2009,75,2,67,144
Oromia,West Arsi,Shashemene Rural,Hedar,3,2010,69,77,82,228
Oromia,West Arsi,Adaba,Hamle,11,2010,15,56,70,141
Oromia,West Wellega,Mendi Hospital,Megabit,7,2010,39,77,27,143
Oromia,North Shewa,Debre Libanos,Teqemt,2,2011,8,63,57,128
Oromia,West Shewa,Ambo,Tir,5,2010,6,73,99,178
Oromia,East Hararge,Deder,Yekatit,6,2010,85,4,42,131
Oromia,West Shewa,Dano,Yekatit,6,2009,6,41,83,130
Oromia,East Wellega,Sibu Sire,Ginbot,9,2010,59,46,25,130
Oromia,Arsi,Limuna Bilbilo,Miyazia,8,2011,8,34,79,121
Oromia,West Shewa,Metarobi,Yekatit,6,2009,40,6,31,77
Oromia,Horo Gudru Wellega,Hababo Guduru,Ginbot,9,2011,85,66,5,156
Oromia,Qeleme Wellega,Gawo Qebe,Meskerem,1,2011,35,31,12,78
Oromia,Qeleme Wellega,Anfilo,Miyazia,8,2011,20,2,76,98
Oromia,Bale,Berbere,Meskerem,1,2010,54,34,5,93
Oromia,West Arsi,Siraro,Sene,10,2010,75,32,96,203
Oromia,East Wellega,Jimma Arjo,Teqemt,2,2011,39,92,54,185
Oromia,West Arsi,Arsi Negele Rural,Sene,10,2010,29,8,10,47
Oromia,Ilu Aba Bora,Yayu,Teqemt,2,2011,92,69,40,201
Oromia,North Shewa,Debre Libanos,Tahesas,4,2010,71,75,0,146
Oromia,Guji,Wadara,Sene,10,2009,16,12,52,80
Oromia,South West Shewa,Kersana Malima,Tir,5,2009,59,24,4,87
Oromia,West Shewa,Midakegni,Nehase,12,2009,26,19,65,110
Oromia,East Hararge,Chelenko Hospital,Teqemt,2,2010,37,92,0,129
Oromia,South West Shewa,Kersana Malima,Megabit,7,2009,95,58,90,243
Oromia,Ilu Aba Bora,Bure,Nehase,12,2009,33,67,78,178
Oromia,West Shewa,Tikur Enchini,Miyazia,8,2010,96,1,29,126
Oromia,Sululta Town,Sululta Town,Miyazia,8,2011,64,40,13,117
Oromia,Jimma,Mana,Hamle,11,2009,22,53,98,173
Oromia,Sebeta Town,Sebeta Town,Yekatit,6,2009,57,78,2,137
Oromia,East Shewa,Gimbichu,Yekatit,6,2010,71,11,75,157
Oromia,Borena,Moyale Hospital,Sene,10,2011,71,9,5,85
Oromia,Ilu Aba Bora,Metu Town,Hedar,3,2010,72,8,52,132
Oromia,West Wellega,Nole Kaba,Miyazia,8,2011,4,66,14,84
Oromia,South West Shewa,Ameya,Nehase,12,2009,67,4,43,114
Oromia,West Wellega,Lata Sibu,Tir,5,2011,69,58,48,175
Oromia,South West Shewa,Goro,Hamle,11,2010,5,30,8,43
Oromia,West Hararge,Bedesa Town,Miyazia,8,2010,73,48,52,173
Oromia,West Hararge,Habro,Yekatit,6,2009,60,83,18,161
Oromia,Qeleme Wellega,Gidami,Miyazia,8,2009,13,7,77,97
Oromia,Finfine Zuria,Sebeta Awas,Sene,10,2011,54,38,68,160
Oromia,East Hararge,Chelenko Hospital,Yekatit,6,2009,19,88,94,201
Oromia,West Guji,Gelana,Tir,5,2011,44,50,80,174
Oromia,West Wellega,Qiltu Kara,Nehase,12,2009,81,98,98,277
Oromia,East Shewa,Gimbichu,Meskerem,1,2010,46,23,76,145
Oromia,Buno Bedele,Chewaqa,Ginbot,9,2010,26,79,84,189
Oromia,West Shewa,Bako Hospital,Miyazia,8,2011,44,16,86,146
Oromia,West Arsi,Kokosa,Hamle,11,2010,77,67,71,215
Oromia,North Shewa,Wuchale,Ginbot,9,2011,28,64,79,171
Oromia,Arsi,Seru,Hedar,3,2010,80,96,96,272
Oromia,North Shewa,Dera Hospital,Tahesas,4,2011,32,82,21,135
Oromia,East Shewa,Matahara,Miyazia,8,2009,98,72,17,187
Oromia,West Wellega,Jarso,Tahesas,4,2011,97,68,1,166
Oromia,Buno Bedele,Dedesa,Sene,10,2011,8,55,21,84
Oromia,Borena,Gomole,Hedar,3,2010,87,76,39,202
Oromia,Guji,Adola Hospital,Teqemt,2,2010,61,80,81,222
Oromia,West Shewa,Dendi,Ginbot,9,2010,19,30,41,90
Oromia,Arsi,Robe,Sene,10,2011,28,61,47,136
Oromia,Guji,Wadara,Nehase,12,2010,78,67,60,205
Oromia,West Shewa,Gojo Hospital,Megabit,7,2009,56,76,66,198
Oromia,Horo Gudru Wellega,Abay Chomen,Teqemt,2,2011,75,35,80,190
Oromia,Jimma,Limu Hospital,Yekatit,6,2011,87,34,27,148
Oromia,Qeleme Wellega,Kake Hosp,Hedar,3,2011,40,10,68,118
Oromia,East Wellega,Nunu Qumba,Miyazia,8,2010,31,25,9,65
Oromia,North Shewa,Dera,Miyazia,8,2010,8,8,0,16
Oromia,North Shewa,Degem,Miyazia,8,2011,31,97,36,164
Oromia,Ilu Aba Bora,Darimu,Miyazia,8,2010,1,43,25,69
Oromia,East Wellega,Nunu Qumba,Ginbot,9,2009,29,16,64,109
Oromia,West Shewa,Midakegni,Meskerem,1,2010,70,63,30,163
Oromia,Horo Gudru Wellega,Abay Chomen,Meskerem,1,2011,92,80,6,178
Oromia,West Wellega,Nejo Town,Tir,5,2009,89,14,71,174
Oromia,Guji,Liben,Megabit,7,2011,11,55,33,99
Oromia,North Shewa,Kimbibit,Nehase,12,2010,15,79,86,180
Oromia,West Shewa,Ambo,Tahesas,4,2011,29,73,30,132
Oromia,West Shewa,Inchini Hospital,Tahesas,4,2011,45,32,87,164
Oromia,East Wellega,Limu,Yekatit,6,2009,21,99,29,149
Oromia,Shashamane Town,Shashamane Town,Meskerem,1,2010,25,86,81,192
Oromia,North Shewa,Yaya Gulele,Tahesas,4,2010,32,95,56,183
Oromia,Guji,Uraga,Ginbot,9,2011,50,47,48,145
Oromia,South West Shewa,Becho,Hedar,3,2011,18,16,21,55
Oromia,Qeleme Wellega,Gidami Hosp,Hedar,3,2011,7,19,25,51
Oromia,Shashamane Town,Shashamane Town,Nehase,12,2010,32,33,55,120
Oromia,East Shewa,Gimbichu,Tir,5,2009,5,27,33,65
Oromia,Borena,El Way,Nehase,12,2010,30,54,9,93
Oromia,Guji,Bore Hospital,Hamle,11,2010,72,12,71,155
Oromia,West Wellega,Genji,Tahesas,4,2010,40,6,18,64
Oromia,Nekemte Town,Nekemte Town,Miyazia,8,2010,10,76,45,131
Oromia,Holeta Town,Holeta Town,Nehase,12,2010,96,90,68,254
Oromia,East Hararge,Midega Tole,Sene,10,2009,50,97,14,161
Oromia,Jimma Spe Town,Jimma Spe Town,Nehase,12,2009,11,22,44,77
Oromia,East Hararge,Kombolicha,Miyazia,8,2011,47,51,77,175
Oromia,Buno Bedele,Boricha,Hedar,3,2010,21,86,79,186
Oromia,Qeleme Wellega,Hawa Gelan,Megabit,7,2009,2,5,52,59
Oromia,West Arsi,Siraro,Miyazia,8,2009,39,11,15,65
Oromia,West Wellega,Begi Hospital,Tir,5,2011,57,34,7,98
Oromia,West Wellega,Nejo Rural,Tir,5,2009,39,83,43,165
Oromia,Arsi,Sire,Hedar,3,2011,85,64,77,226
Oromia,North Shewa,Dera Hospital,Miyazia,8,2009,61,96,54,211
Oromia,Buno Bedele,Bedele Zuriya,Hedar,3,2010,66,99,33,198
Oromia,West Wellega,Gimbi Adventist Hospital,Megabit,7,2011,57,74,38,169
Oromia,West Arsi,Nensebo,Sene,10,2011,69,64,28,161
Oromia,West Wellega,Homa,Teqemt,2,2011,84,0,46,130
Oromia,Jimma,Omo Nada Hospital,Megabit,7,2011,0,53,15,68
Oromia,West Hararge,Habro,Hamle,11,2009,28,1,20,49
Oromia,East Wellega,Gida Ayana,Meskerem,1,2011,13,61,17,91
Oromia,North Shewa,Aleiltu,Miyazia,8,2010,15,31,1,47
Oromia,Jimma,Gera,Yekatit,6,2010,97,3,36,136
Oromia,West Wellega,Kundala,Meskerem,1,2011,62,43,6,111
Oromia,Jimma,B/Tolyi,Nehase,12,2009,50,21,81,152
Oromia,Bale,Ginir Town,Hedar,3,2011,67,61,64,192
Oromia,Buno Bedele,Meko,Sene,10,2010,78,2,26,106
Oromia,Ilu Aba Bora,Yayu,Yekatit,6,2010,33,70,30,133
Oromia,North Shewa,Dera,Nehase,12,2009,3,82,69,154
Oromia,Jimma,Kersa,Megabit,7,2011,35,52,9,96
Oromia,East Hararge,Bedeno,Megabit,7,2011,4,23,41,68
Oromia,Arsi,Bale Gesgara,Sene,10,2010,58,93,35,186
Oromia,East Hararge,Bisidimo Hospital,Megabit,7,2010,76,57,4,137
Oromia,Horo Gudru Wellega,Shambu Hospital,Nehase,12,2010,27,54,9,90
Oromia,Horo Gudru Wellega,Amuru,Sene,10,2009,92,41,20,153
Oromia,West Wellega,Lalo Asabi,Meskerem,1,2010,36,63,54,153
Oromia,West Guji,Hanbala,Tir,5,2009,40,66,35,141
Oromia,Qeleme Wellega,Gawo Qebe,Megabit,7,2009,17,93,26,136
Oromia,Bale,Goro,Megabit,7,2009,71,73,87,231
Oromia,East Hararge,Kumbi,Nehase,12,2009,40,78,97,215
Oromia,Horo Gudru Wellega,Amuru,Sene,10,2011,64,67,15,146
Oromia,West Guji,Hanbala,Yekatit,6,2009,9,63,10,82
Oromia,Robe Town,Robe Town,Ginbot,9,2010,51,80,90,221
Oromia,East Hararge,Goro Gutu,Hedar,3,2011,26,23,39,88
Oromia,West Shewa,Midakegni,Sene,10,2010,5,93,22,120
Oromia,South West Shewa,Tulu Bolo Hospital,Tir,5,2011,44,24,80,148
Oromia,East Wellega,Sibu Sire,Ginbot,9,2010,43,40,86,169
Oromia,West Wellega,Guliso,Meskerem,1,2011,65,69,3,137
Oromia,Borena,Yabelo Rural,Tir,5,2009,40,71,60,171
Oromia,West Shewa,Metarobi,Hedar,3,2010,47,81,46,174
Oromia,Dukem Town,Dukem Town,Tir,5,2011,56,84,39,179
Oromia,East Wellega,Wama Hagelo,Teqemt,2,2010,43,63,84,190
Oromia,Borena,Yabelo,Yekatit,6,2010,51,43,79,173
Oromia,Horo Gudru Wellega,Jima Geneti,Megabit,7,2010,66,30,79,175
Oromia,Adama Special Town,Adama Town,Sene,10,2011,66,99,78,243
Oromia,Qeleme Wellega,Seyo,Miyazia,8,2010,26,64,6,96
Oromia,Jimma,Sigmo,Ginbot,9,2010,84,36,45,165
Oromia,West Arsi,Kofele,Sene,10,2011,65,60,90,215
Oromia,Sebeta Town,Sebeta Town,Megabit,7,2010,3,27,79,109
Oromia,East Hararge,Chinakesen,Miyazia,8,2011,43,86,88,217
Oromia,Bale,Gololcha,Megabit,7,2010,79,48,85,212
Oromia,Ilu Aba Bora,Becho,Ginbot,9,2011,64,94,45,203
Oromia,West Wellega,Homa,Megabit,7,2010,40,19,90,149
Oromia,East Hararge,Babile,Meskerem,1,2011,38,87,47,172
Oromia,Borena,Dhas,Nehase,12,2009,16,73,25,114
Oromia,North Shewa,Were Jarso,Ginbot,9,2010,81,49,65,195
Oromia,West Shewa,Ginde Beret,Hedar,3,2011,83,4,81,168
Oromia,East Shewa,Boset,Megabit,7,2009,92,68,81,241
Oromia,Guji,Dima,Hamle,11,2010,74,3,25,102
Oromia,East Shewa,Liben,Hamle,11,2009,30,7,61,98
Oromia,East Hararge,Goro Gutu,Meskerem,1,2011,4,92,80,176
Oromia,North Shewa,Fiche Hospital,Hedar,3,2010,35,61,3,99
Oromia,Jimma,Sekoru,Sene,10,2009,66,83,52,201
Oromia,Arsi,Digeluna Tijo,Miyazia,8,2011,81,97,7,185
Oromia,Finfine Zuria,Berreh,Yekatit,6,2010,87,87,30,204
Oromia,Gelan Town,Gelan Town,Megabit,7,2011,87,54,59,200
Oromia,Jimma,Mancho,Ginbot,9,2009,4,99,10,113
Oromia,Bale,Raitu,Miyazia,8,2010,47,42,55,144
Oromia,Buno Bedele,Bedele Hospital,Hamle,11,2009,54,7,35,96
Oromia,South West Shewa,Goro,Megabit,7,2011,40,16,95,151
Oromia,West Wellega,Boji Cheqorsa,Miyazia,8,2010,72,59,47,178
Oromia,Bale,Dawe Qachen,Hamle,11,2009,16,26,4,46
Oromia,Guji,Liben,Tir,5,2011,68,14,54,136
Oromia,Arsi,Seru,Miyazia,8,2010,18,47,9,74
Oromia,West Wellega,Kundala,Megabit,7,2009,80,98,73,251
Oromia,Finfine Zuria,Walmera,Tahesas,4,2010,76,16,70,162
Oromia,Guji,Adola Reda,Meskerem,1,2010,47,14,92,153
Oromia,Guji,Adola Town,Tir,5,2011,79,44,26,149
Oromia,Guji,Adola Hospital,Miyazia,8,2011,11,64,47,122
Oromia,West Shewa,Ambo,Yekatit,6,2011,57,38,79,174
Oromia,East Shewa,Liben,Hedar,3,2010,19,48,35,102
Oromia,Arsi,Sire,Yekatit,6,2011,66,65,30,161
Oromia,Horo Gudru Wellega,Jima Geneti,Miyazia,8,2010,83,29,84,196
Oromia,Arsi,Digeluna Tijo,Meskerem,1,2010,97,71,62,230
Oromia,East Hararge,Gole Oda,Meskerem,1,2010,29,2,80,111
Oromia,Bale,Gasera,Meskerem,1,2010,34,51,43,128
Oromia,Dukem Town,Dukem Town,Megabit,7,2009,52,0,18,70
Oromia,West Wellega,Boji Dermeji,Nehase,12,2009,39,11,39,89
Oromia,East Hararge,Bedeno,Tahesas,4,2011,86,57,93,236
Oromia,West Hararge,Habro,Tir,5,2011,10,99,86,195
Oromia,Jimma,Setema Hospital,Ginbot,9,2011,37,63,5,105
Oromia,Jimma,Chora Boter,Sene,10,2009,24,20,0,44
Oromia,West Shewa,Gedo Hospital,Tir,5,2011,19,30,99,148
Oromia,East Hararge,Kombolicha,Tir,5,2009,65,97,37,199
Oromia,West Shewa,Gojo Hospital,Tir,5,2010,17,69,42,128
Oromia,West Hararge,Tulo,Tir,5,2011,38,0,66,104
Oromia,Jimma,Limu Hospital,Tir,5,2010,19,91,41,151
Oromia,East Wellega,Haro Limu,Sene,10,2010,48,94,53,195
Oromia,Sululta Town,Sululta Town,Yekatit,6,2010,24,86,34,144
Oromia,Borena,Dire,Tahesas,4,2011,71,75,31,177
Oromia,West Guji,Mkelka Soda,Miyazia,8,2011,22,46,74,142
Oromia,Bale,Raitu,Hedar,3,2011,20,60,17,97
Oromia,Borena,Arero,Teqemt,2,2011,33,55,31,119
Oromia,Buno Bedele,Diga,Miyazia,8,2009,53,30,59,142
Oromia,Horo Gudru Wellega,Jarte Jardga,Hedar,3,2011,86,62,91,239
Oromia,Bale,Seweyna,Tir,5,2010,20,62,98,180
Oromia,Borena,Moyale Hospital,Sene,10,2009,88,68,33,189
Oromia,West Shewa,Chelia,Nehase,12,2010,51,29,87,167
Oromia,East Hararge,Chelenko Hospital,Ginbot,9,2011,57,41,72,170
Oromia,West Arsi,Dodola Rural,Hamle,11,2010,39,52,86,177
Oromia,West Wellega,Lalo Asabi,Megabit,7,2009,45,15,9,69
Oromia,East Wellega,Nunu Qumba,Teqemt,2,2011,36,68,36,140
Oromia,Bale,Raitu,Teqemt,2,2010,31,61,30,122
Oromia,East Shewa,Dugda,Sene,10,2009,47,41,80,168
Oromia,Buno Bedele,Bedele Hospital,Ginbot,9,2011,37,0,92,129
Oromia,East Wellega,Gobu Seyo,Hedar,3,2011,98,9,49,156
Oromia,Arsi,Limuna Bilbilo,Tir,5,2010,21,57,48,126
Oromia,West Wellega,Lalo Asabi,Megabit,7,2009,83,38,0,121
Oromia,West Arsi,Kokosa,Tahesas,4,2011,0,81,12,93
Oromia,Ilu Aba Bora,Metu Town,Tahesas,4,2011,78,45,31,154
Oromia,West Shewa,Ginde Beret,Megabit,7,2009,57,43,14,114
Oromia,West Hararge,Hawi Gudina,Yekatit,6,2010,59,37,70,166
Oromia,East Hararge,Babile,Ginbot,9,2011,75,74,3,152
Oromia,Qeleme Wellega,Anfilo,Hedar,3,2011,20,67,80,167
Oromia,West Wellega,Kundala,Sene,10,2010,78,85,61,224
Oromia,Borena,Dhas,Teqemt,2,2011,89,74,28,191
Oromia,East Shewa,Matahara,Megabit,7,2009,97,68,82,247
Oromia,West Shewa,Metarobi,Tir,5,2011,45,78,36,159
Oromia,West Shewa,Ginde Beret,Teqemt,2,2011,75,17,55,147
Oromia,West Wellega,Boji Dermeji,Ginbot,9,2010,9,99,16,124
Oromia,West Wellega,Nole Kaba,Hedar,3,2011,76,85,57,218
Oromia,West Wellega,Begi,Hamle,11,2010,9,39,17,65
Oromia,West Shewa,Chelia,Teqemt,2,2010,12,80,41,133
Oromia,East Shewa,Gimbichu,Miyazia,8,2010,87,86,47,220
Oromia,North Shewa,Abichugna,Sene,10,2010,76,82,98,256
Oromia,West Hararge,Gemechis,Tahesas,4,2010,74,6,67,147
Oromia,Ilu Aba Bora,Doreni,Tahesas,4,2010,71,43,6,120
Oromia,West Wellega,Nejo Hospital,Nehase,12,2009,48,89,68,205
Oromia,West Arsi,Siraro,Teqemt,2,2011,90,12,62,164
Oromia,East Shewa,Gimbichu,Megabit,7,2009,21,13,62,96
Oromia,East Hararge,Kombolicha,Miyazia,8,2010,22,63,66,151
Oromia,West Wellega,Nejo Rural,Megabit,7,2011,12,5,77,94
Oromia,Guji,Anna Sora,Sene,10,2009,7,2,84,93
Oromia,North Shewa,Degem,Megabit,7,2011,44,36,74,154
Oromia,Jimma,Dedo,Yekatit,6,2010,39,29,90,158
Oromia,West Guji,Bule Hora,Sene,10,2010,22,31,42,95
Oromia,East Hararge,Garemuleta Hospital,Sene,10,2010,88,98,8,194
Oromia,Qeleme Wellega,Anfilo,Tir,5,2009,71,18,98,187
Oromia,Bale,Berbere,Sene,10,2010,97,2,72,171
Oromia,West Hararge,Gelemso Hospital,Megabit,7,2010,76,79,58,213
Oromia,East Wellega,Sasiga,Teqemt,2,2010,61,67,96,224
Oromia,West Wellega,Gimbi Adventist Hospital,Megabit,7,2010,76,64,75,215
Oromia,West Guji,Bule Hora,Tahesas,4,2011,26,51,63,140
Oromia,Woliso Town,Woliso Town,Ginbot,9,2010,21,99,79,199
Oromia,West Wellega,Lalo Asabi,Yekatit,6,2009,32,74,49,155
Oromia,Horo Gudru Wellega,Shambu Town,Meskerem,1,2011,61,99,72,232
Oromia,East Wellega,Limu,Sene,10,2011,67,28,46,141
Oromia,West Hararge,Tulo,Hedar,3,2010,58,36,76,170
Oromia,Qeleme Wellega,Anfilo,Miyazia,8,2009,4,71,14,89
Oromia,West Hararge,Oda Bultum,Tir,5,2011,21,55,51,127
Oromia,North Shewa,Jido,Nehase,12,2010,37,1,10,48
Oromia,Jimma,Kersa,Teqemt,2,2011,98,13,13,124
Oromia,West Wellega,Gimbi Public  Hospital,Hedar,3,2011,42,12,31,85
Oromia,Borena,Dhas,Hedar,3,2010,34,89,32,155
Oromia,Jimma,O/Beyam,Meskerem,1,2011,60,26,90,176
Oromia,West Arsi,Bishan Guracha Town,Ginbot,9,2009,36,94,62,192
Oromia,West Shewa,Ginde Beret,Ginbot,9,2010,51,88,4,143
Oromia,Qeleme Wellega,Hawa Gelan,Yekatit,6,2011,8,93,23,124
Oromia,Borena,El Way,Sene,10,2010,57,8,15,80
Oromia,East Shewa,Adami Tulu Jido Kombolcha,Megabit,7,2009,97,18,14,129
Oromia,North Shewa,Were Jarso,Megabit,7,2011,95,98,21,214
Oromia,East Shewa,Lomme,Hedar,3,2011,38,97,39,174
Oromia,Arsi,Tiyo,Hedar,3,2011,86,14,80,180
Oromia,North Shewa,Were Jarso,Sene,10,2009,46,30,27,103
Oromia,West Wellega,Gimbi Rural,Miyazia,8,2009,10,69,37,116
Oromia,West Shewa,Dano,Nehase,12,2009,5,52,30,87
Oromia,Finfine Zuria,Sululta Town,Ginbot,9,2010,97,21,74,192
Oromia,West Shewa,Inchini Hospital,Hedar,3,2010,47,71,44,162
Oromia,West Arsi,Dodola Rural,Yekatit,6,2009,68,41,3,112
Oromia,East Wellega,Haro Limu,Nehase,12,2009,70,67,85,222
Oromia,Horo Gudru Wellega,Horo,Nehase,12,2010,76,65,16,157
Oromia,North Shewa,Debre Libanos,Sene,10,2011,37,92,91,220
Oromia,Sebeta Town,Sebeta Town,Nehase,12,2010,5,99,90,194
Oromia,Guji,Negele Hospital,Meskerem,1,2010,54,67,3,124
Oromia,Horo Gudru Wellega,Gudru,Meskerem,1,2011,62,24,64,150
Oromia,Arsi,Bekoji Town,Miyazia,8,2009,7,51,76,134
Oromia,West Guji,Bule Hora Toun,Ginbot,9,2010,14,22,36,72
Oromia,East Shewa,Adea,Meskerem,1,2011,21,70,83,174
Oromia,West Wellega,Gimbi Rural,Hamle,11,2010,71,17,90,178
Oromia,East Hararge,Bisidimo Hospital,Megabit,7,2010,16,48,4,68
Oromia,North Shewa,Degem,Sene,10,2009,95,2,41,138
Oromia,West Shewa,Elifata,Tahesas,4,2011,63,24,67,154
Oromia,Sululta Town,Sululta Town,Yekatit,6,2009,11,69,84,164
Oromia,Ilu Aba Bora,Metu Rural,Tir,5,2009,65,15,87,167
Oromia,Modjo Town,Modjo Town,Miyazia,8,2011,65,28,96,189
Oromia,Borena,Dilo,Hedar,3,2011,68,53,74,195
Oromia,Arsi,Seru,Miyazia,8,2011,44,94,26,164
Oromia,East Shewa,Lomme,Sene,10,2009,85,24,95,204
Oromia,West Wellega,Genji,Ginbot,9,2009,83,96,7,186
Oromia,Adama Special Town,Adama Town,Tir,5,2010,90,51,98,239
Oromia,Sebeta Town,Sebeta Town,Yekatit,6,2010,59,42,0,101
Oromia,West Shewa,Gedo Hospital,Meskerem,1,2010,21,72,2,95
Oromia,West Guji,Hanbala,Tir,5,2009,47,4,79,130
Oromia,West Arsi,Dodola Rural,Miyazia,8,2009,19,70,46,135
Oromia,Jimma,Tiro Afeta,Meskerem,1,2011,74,24,50,148
Oromia,Sululta Town,Sululta Town,Hedar,3,2011,88,28,4,120
Oromia,Qeleme Wellega,Dambi Dolo Hospital,Megabit,7,2011,51,54,48,153
Oromia,Bale,Sinana,Yekatit,6,2009,46,80,39,165
Oromia,East Hararge,Gursum,Hedar,3,2010,69,97,91,257
Oromia,Ilu Aba Bora,Ale,Yekatit,6,2009,21,96,44,161
Oromia,East Wellega,Nunu Qumba,Ginbot,9,2010,30,60,13,103
Oromia,Bale,Ginir,Sene,10,2010,11,22,64,97
Oromia,West Shewa,Ejerie,Ginbot,9,2010,57,51,69,177
Oromia,West Wellega,Yubdo,Tahesas,4,2010,40,58,31,129
Oromia,Guji,Negele Town,Sene,10,2010,5,10,95,110
Oromia,Guji,Saba Boru,Meskerem,1,2010,54,49,16,119
Oromia,Horo Gudru Wellega,Amuru,Hedar,3,2011,9,82,23,114
Oromia,East Wellega,Sibu Sire,Hamle,11,2010,45,87,63,195
Oromia,East Shewa,Adama,Ginbot,9,2011,38,3,18,59
Oromia,East Shewa,Adama,Ginbot,9,2009,59,85,31,175
Oromia,Woliso Town,Woliso Town,Ginbot,9,2010,3,33,73,109
Oromia,West Shewa,Codi,Tir,5,2010,97,0,49,146
Oromia,Bale,Gasera,Tahesas,4,2011,5,67,50,122
Oromia,Guji,Negele Hospital,Megabit,7,2009,71,11,51,133
Oromia,Sebeta Town,Sebeta Town,Yekatit,6,2011,14,16,45,75
Oromia,West Hararge,Habro,Tir,5,2009,87,40,42,169
Oromia,East Wellega,Gudeyabila,Teqemt,2,2010,98,67,9,174
Oromia,Lege Dadi Lege Tafo Town,Lege Dadi Lege Tafo Town,Hedar,3,2011,79,76,44,199
Oromia,Buno Bedele,Gechi,Tir,5,2009,95,76,67,238
Oromia,West Wellega,Genji,Teqemt,2,2010,89,46,8,143
Oromia,Borena,El Way,Meskerem,1,2011,92,15,26,133
Oromia,Jimma,Limu Kosa,Miyazia,8,2011,78,29,43,150
Oromia,West Arsi,Hebal Arsi,Meskerem,1,2010,21,18,78,117
Oromia,East Wellega,Gida Ayana,Miyazia,8,2010,47,85,23,155
Oromia,Guji,Girja,Sene,10,2009,24,4,40,68
Oromia,West Arsi,Gedeb Asasa,Tahesas,4,2011,53,77,5,135
Oromia,Robe Town,Robe Town,Sene,10,2010,53,76,74,203
Oromia,West Hararge,Guba Qoricha,Meskerem,1,2010,55,60,47,162
Oromia,Ilu Aba Bora,Ale,Nehase,12,2010,81,39,51,171
Oromia,West Shewa,Tibe Kutaye,Miyazia,8,2011,90,47,67,204
Oromia,Jimma,Chora Boter,Yekatit,6,2009,66,90,81,237
Oromia,West Shewa,Ginde Beret,Hedar,3,2010,33,94,81,208
Oromia,East Hararge,Kurfa Chele,Ginbot,9,2009,25,72,88,185
Oromia,West Wellega,Yubdo,Miyazia,8,2009,57,38,94,189
Oromia,East Hararge,Haromaya Hospital,Megabit,7,2009,60,97,94,251
Oromia,West Shewa,Ambo Hospital,Hedar,3,2010,96,50,43,189
Oromia,Ilu Aba Bora,Hurumu,Hamle,11,2009,2,62,88,152
Oromia,North Shewa,Girar Jarso,Meskerem,1,2010,41,86,42,169
Oromia,South West Shewa,Becho,Megabit,7,2009,51,7,80,138
Oromia,West Wellega,Guliso,Ginbot,9,2009,53,48,10,111
Oromia,Arsi,Tena,Megabit,7,2011,48,96,56,200
Oromia,East Wellega,Gudeyabila,Tahesas,4,2010,44,49,81,174
Oromia,West Wellega,Babo Gembel,Tir,5,2011,20,8,31,59
Oromia,West Wellega,Lalo Asabi,Miyazia,8,2009,94,62,81,237
Oromia,Qeleme Wellega,Dambi Dolo Hospital,Hedar,3,2011,28,35,14,77
Oromia,West Guji,Suro Barguda,Megabit,7,2009,84,83,72,239
Oromia,West Wellega,Begi Hospital,Tahesas,4,2010,72,28,24,124
Oromia,West Wellega,Nejo Rural,Hedar,3,2011,76,7,46,129
Oromia,Arsi,Shenan Kolu,Sene,10,2010,14,83,34,131
Oromia,Adama Special Town,Adama Town,Tahesas,4,2010,79,39,88,206
Oromia,West Wellega,Guliso,Miyazia,8,2010,60,16,10,86
Oromia,West Shewa,Elifata,Meskerem,1,2011,86,38,93,217
Oromia,East Wellega,Kiremu,Meskerem,1,2010,4,7,42,53
Oromia,East Hararge,Babile,Tir,5,2010,26,38,17,81
Oromia,Horo Gudru Wellega,Amuru,Tahesas,4,2011,71,71,40,182
Oromia,West Shewa,Metarobi,Tahesas,4,2010,79,59,2,140
Oromia,West Arsi,Arsi Negele Town,Miyazia,8,2011,11,71,37,119
Oromia,West Wellega,Jarso,Tir,5,2011,67,36,65,168
Oromia,West Shewa,Midakegni,Hamle,11,2010,20,97,44,161
Oromia,Ilu Aba Bora,Darimu,Miyazia,8,2011,40,52,92,184
Oromia,Finfine Zuria,Berreh,Meskerem,1,2011,64,79,32,175
Oromia,East Hararge,Goro Muti,Tahesas,4,2010,20,63,38,121
Oromia,Gelan Town,Gelan Town,Ginbot,9,2011,65,49,98,212
Oromia,East Wellega,Wama Hagelo,Ginbot,9,2011,73,60,90,223
Oromia,West Wellega,Homa,Meskerem,1,2010,69,85,46,200
Oromia,West Shewa,Tikur Enchini,Megabit,7,2009,48,89,33,170
Oromia,North Shewa,Were Jarso,Ginbot,9,2011,11,72,30,113
Oromia,West Arsi,Bishan Guracha Town,Sene,10,2010,29,3,75,107
Oromia,North Shewa,Kuyu,Teqemt,2,2011,75,96,87,258
Oromia,Bale,Agarfa,Miyazia,8,2010,60,31,89,180
Oromia,Horo Gudru Wellega,Jima Rare,Teqemt,2,2011,71,62,43,176
Oromia,West Arsi,Siraro,Teqemt,2,2011,72,48,27,147
Oromia,East Wellega,Jimma Arjo,Hedar,3,2011,33,78,53,164
Oromia,West Shewa,Jibat,Megabit,7,2010,21,74,12,107
Oromia,West Wellega,Begi,Miyazia,8,2011,23,19,21,63
Oromia,East Hararge,Gursum,Megabit,7,2009,31,61,30,122
Oromia,Finfine Zuria,Akaki,Meskerem,1,2011,38,16,51,105
Oromia,East Wellega,Nunu Qumba,Yekatit,6,2009,28,99,59,186
Oromia,West Guji,Suro Barguda,Megabit,7,2010,26,30,29,85
Oromia,West Shewa,Ejersa Lafo,Megabit,7,2009,26,21,95,142
Oromia,West Guji,Kercha,Nehase,12,2010,63,11,7,81
Oromia,West Shewa,Tibe Kutaye,Yekatit,6,2009,4,2,66,72
Oromia,East Hararge,Deder Town,Teqemt,2,2010,34,59,5,98
Oromia,Bale,Sinana,Hamle,11,2009,50,55,62,167
Oromia,East Hararge,Fedis,Megabit,7,2011,94,53,29,176
Oromia,West Hararge,West Harerge	Gumbi Bordede,Sene,10,2011,75,54,58,187
Oromia,North Shewa,Kuyu Hospital,Megabit,7,2011,35,34,21,90
Oromia,Bale,Dawe Serar,Ginbot,9,2010,72,6,85,163
Oromia,Arsi,Sire,Teqemt,2,2010,32,76,66,174
Oromia,Guji,Odo Shakiso,Meskerem,1,2011,1,7,74,82
Oromia,Ilu Aba Bora,Darimu,Meskerem,1,2011,68,56,30,154
Oromia,East Wellega,Guto Gida,Megabit,7,2011,42,43,50,135
Oromia,Ilu Aba Bora,Yayu,Hamle,11,2009,20,39,82,141
Oromia,North Shewa,Abichugna,Megabit,7,2011,49,41,80,170
Oromia,West Guji,Hanbala,Teqemt,2,2011,89,5,28,122
Oromia,Shashamane Town,Shashamane Town,Sene,10,2010,79,12,91,182
Oromia,Arsi,Gololcha,Tahesas,4,2011,15,45,15,75
Oromia,North Shewa,Aleiltu,Teqemt,2,2011,73,29,25,127
Oromia,Ilu Aba Bora,Bure,Meskerem,1,2010,21,73,40,134
Oromia,West Shewa,Abuna Gindeberet,Miyazia,8,2010,22,32,19,73
Oromia,North Shewa,Dera Hospital,Yekatit,6,2009,6,4,90,100
Oromia,Jimma,Limu Hospital,Yekatit,6,2010,30,55,95,180
Oromia,Ilu Aba Bora,Algesachi,Hedar,3,2010,24,13,41,78
Oromia,West Arsi,Siraro,Meskerem,1,2011,16,37,30,83
Oromia,West Arsi,Kofele,Sene,10,2011,4,12,79,95
Oromia,Arsi,Aseko,Tahesas,4,2010,14,62,56,132
Oromia,Ilu Aba Bora,Didu,Tir,5,2010,34,81,31,146
Oromia,Buno Bedele,Chora,Yekatit,6,2010,0,38,11,49
Oromia,West Hararge,Gelemso Hospital,Sene,10,2009,44,57,74,175
Oromia,West Arsi,Dodola Rural,Tir,5,2009,85,64,35,184
Oromia,Bishoftu Town,Bishoftu Town,Tir,5,2009,81,56,8,145
Oromia,Guji,Wadara,Megabit,7,2009,44,41,21,106
Oromia,East Hararge,Midega Tole,Nehase,12,2010,18,53,65,136
Oromia,Borena,Moyale,Tahesas,4,2010,94,81,98,273
Oromia,Jimma,Limu Seka,Ginbot,9,2009,38,1,17,56
Oromia,Qeleme Wellega,Laloqile,Nehase,12,2010,99,64,37,200
Oromia,Jimma,Agaro Hospital,Tahesas,4,2011,72,56,15,143
Oromia,North Shewa,Girar Jarso,Tahesas,4,2010,79,80,14,173
Oromia,South West Shewa,Ameya Hospital,Miyazia,8,2010,65,2,46,113
Oromia,Borena,El Way,Megabit,7,2010,90,71,12,173
Oromia,North Shewa,Kuyu Hospital,Miyazia,8,2011,71,0,39,110
Oromia,Jimma,B/Tolyi,Tahesas,4,2011,37,5,61,103
Oromia,Guji,Wadara,Tahesas,4,2010,90,17,17,124
Oromia,Bale,Agarfa,Tahesas,4,2010,22,5,17,44
Oromia,Arsi,Merti,Megabit,7,2011,64,33,75,172
Oromia,Bale,Dawe Serar,Yekatit,6,2011,63,23,60,146
Oromia,Buno Bedele,Dapho Hana,Tahesas,4,2010,65,72,74,211
Oromia,Finfine Zuria,Berreh,Miyazia,8,2010,65,78,11,154
Oromia,Horo Gudru Wellega,Jima Geneti,Yekatit,6,2011,14,71,7,92
Oromia,West Shewa,Ambo Hospital,Ginbot,9,2010,12,38,85,135
Oromia,East Hararge,Deder Hospital,Megabit,7,2011,87,36,64,187
Oromia,Ilu Aba Bora,Becho,Nehase,12,2009,55,38,2,95
Oromia,Qeleme Wellega,Gidami,Megabit,7,2010,13,46,80,139
Oromia,Jimma,Dedo,Megabit,7,2009,12,99,1,112
Oromia,Jimma,Mana,Meskerem,1,2010,7,94,13,114
Oromia,Ilu Aba Bora,Algesachi,Miyazia,8,2010,14,28,77,119
Oromia,West Wellega,Qiltu Kara,Teqemt,2,2011,86,65,76,227
Oromia,East Wellega,Gudeyabila,Hedar,3,2010,2,78,41,121
Oromia,West Hararge,Boke,Yekatit,6,2010,61,95,72,228
Oromia,West Wellega,Nejo Town,Tir,5,2011,40,51,11,102
Oromia,Arsi,Sude,Megabit,7,2011,8,96,98,202
Oromia,Qeleme Wellega,Dambi Dolo Hospital,Teqemt,2,2010,81,77,17,175
Oromia,Lege Dadi Lege Tafo Town,Lege Dadi Lege Tafo Town,Sene,10,2011,95,18,74,187
Oromia,Horo Gudru Wellega,Jima Rare,Ginbot,9,2010,79,81,23,183
Oromia,West Wellega,Gimbi Adventist Hospital,Teqemt,2,2011,61,27,44,132
Oromia,West Shewa,Gedo Hospital,Yekatit,6,2011,76,71,25,172
Oromia,Jimma,Omonada,Nehase,12,2010,49,50,40,139
Oromia,West Wellega,Gimbi Adventist Hospital,Meskerem,1,2010,33,27,72,132
Oromia,West Hararge,Mesela,Teqemt,2,2010,31,85,37,153
Oromia,Jimma,Seka Chekorsa,Tir,5,2010,59,16,4,79
Oromia,Guji,Aga Wayyu,Megabit,7,2010,25,44,80,149
Oromia,Bale,Ginir Town,Ginbot,9,2009,67,91,10,168
Oromia,East Wellega,Wama Hagelo,Megabit,7,2011,73,90,76,239
Oromia,Bale,Sinana,Megabit,7,2009,60,74,18,152
Oromia,West Arsi,Dodola Rural,Teqemt,2,2011,3,40,51,94
Oromia,Jimma,Kersa,Tir,5,2011,27,19,37,83
Oromia,West Wellega,Babo Gembel,Megabit,7,2009,39,90,69,198
Oromia,West Hararge,Boke,Sene,10,2011,56,22,65,143
Oromia,East Wellega,Haro Limu,Ginbot,9,2011,62,9,44,115
Oromia,Guji,Dima,Nehase,12,2010,21,28,19,68
Oromia,Jimma,Guma,Tir,5,2010,53,73,56,182
Oromia,Horo Gudru Wellega,Amuru,Teqemt,2,2010,89,89,77,255
Oromia,East Hararge,Deder,Hedar,3,2011,7,63,14,84
Oromia,Qeleme Wellega,Laloqile,Megabit,7,2009,49,84,90,223
Oromia,Borena,Moyale Hospital,Hedar,3,2011,67,76,49,192
Oromia,Bale,Gasera,Tahesas,4,2010,25,21,95,141
Oromia,West Shewa,Ambo University  Hosp,Tir,5,2011,35,99,54,188
Oromia,Robe Town,Robe Town,Miyazia,8,2010,9,1,95,105
Oromia,Arsi,Zeway Dugda,Meskerem,1,2011,59,40,29,128
Oromia,West Arsi,Dodola Rural,Yekatit,6,2009,80,6,92,178
Oromia,Buno Bedele,Chora,Tir,5,2011,48,13,82,143
Oromia,East Hararge,Aweday Town,Ginbot,9,2009,91,55,5,151
Oromia,Jimma,Guma,Miyazia,8,2009,36,15,2,53
Oromia,Bale,Legehida,Ginbot,9,2009,9,19,84,112
Oromia,West Guji,Bule Hora Toun,Nehase,12,2009,3,91,2,96
Oromia,East Hararge,Garemuleta Hospital,Miyazia,8,2009,86,65,70,221
Oromia,North Shewa,Degem,Teqemt,2,2010,53,53,3,109
Oromia,West Guji,Biebirsa Kojowa,Ginbot,9,2009,56,18,34,108
Oromia,Bale,Delo Mena,Megabit,7,2009,13,73,12,98
Oromia,South West Shewa,Ameya Hospital,Hedar,3,2011,7,83,17,107
Oromia,Ambo Town,Ambo Town,Sene,10,2011,83,89,42,214
Oromia,West Wellega,Homa,Tahesas,4,2011,89,28,40,157
Oromia,Jimma,Gomma,Hedar,3,2011,86,81,74,241
Oromia,West Arsi,Loke Hada Hospital,Sene,10,2011,53,50,27,130
Oromia,Guji,Odo Shakiso,Tahesas,4,2010,99,37,12,148
Oromia,East Hararge,Babile,Megabit,7,2009,59,40,51,150
Oromia,North Shewa,Kuyu Hospital,Miyazia,8,2011,89,49,4,142
Oromia,East Hararge,Haromaya Rural,Ginbot,9,2009,86,67,15,168
Oromia,East Hararge,Babile,Hedar,3,2010,36,82,86,204
Oromia,West Hararge,Doba,Yekatit,6,2009,22,10,79,111
Oromia,Buno Bedele,Meko,Tir,5,2010,55,4,80,139
Oromia,East Shewa,Dugda,Yekatit,6,2011,77,48,36,161
Oromia,East Hararge,Bedeno,Ginbot,9,2009,28,23,24,75
Oromia,East Hararge,Goro Gutu,Ginbot,9,2010,12,58,76,146
Oromia,East Wellega,Sibu Sire,Miyazia,8,2010,84,15,82,181
Oromia,West Shewa,Dano,Ginbot,9,2011,73,55,53,181
Oromia,West Arsi,Nensebo,Meskerem,1,2010,70,27,41,138
Oromia,Bale,Legehida,Tir,5,2011,12,97,48,157
Oromia,Horo Gudru Wellega,Amuru,Megabit,7,2011,3,40,69,112
Oromia,West Shewa,Tibe Kutaye,Hedar,3,2011,90,41,43,174
Oromia,Nekemte Town,Nekemte Town,Ginbot,9,2011,5,5,22,32
Oromia,Jimma,Nono Benja,Miyazia,8,2010,43,49,85,177
Oromia,West Arsi,Bishan Guracha Town,Teqemt,2,2011,50,76,91,217
Oromia,South West Shewa,Sodo Dac'Ha,Nehase,12,2009,6,1,66,73
Oromia,East Shewa,Batu,Tir,5,2011,25,97,56,178
Oromia,Jimma,Limu Hospital,Ginbot,9,2011,54,21,11,86
Oromia,Ilu Aba Bora,Doreni,Yekatit,6,2011,27,67,53,147
Oromia,Guji,Dima,Ginbot,9,2009,3,30,39,72
Oromia,South West Shewa,Goro,Megabit,7,2009,37,81,82,200
Oromia,Bale,Berbere,Ginbot,9,2011,51,52,35,138
Oromia,East Hararge,Meta,Tahesas,4,2010,2,77,35,114
Oromia,West Shewa,Abuna Gindeberet,Miyazia,8,2011,23,26,30,79
Oromia,North Shewa,Kimbibit,Yekatit,6,2011,91,82,55,228
Oromia,Horo Gudru Wellega,Jima Geneti,Tir,5,2009,74,7,8,89
Oromia,Finfine Zuria,Sandefa,Megabit,7,2009,6,66,62,134
Oromia,West Wellega,Genji,Megabit,7,2009,53,94,89,236
Oromia,Borena,Yabelo Hospital,Ginbot,9,2009,77,74,96,247
Oromia,East Hararge,Midega Tole,Tir,5,2011,81,11,56,148
Oromia,Buno Bedele,Dedesa,Sene,10,2011,39,24,65,128
Oromia,East Wellega,Gida Ayana,Ginbot,9,2011,79,14,35,128
Oromia,South West Shewa,Goro,Tir,5,2010,57,17,29,103
Oromia,East Hararge,Chelenko Hospital,Miyazia,8,2011,99,67,7,173
Oromia,East Wellega,Haro Limu,Miyazia,8,2011,35,9,58,102
Oromia,North Shewa,Jido,Ginbot,9,2009,63,89,18,170
Oromia,West Wellega,Seyo Nole,Meskerem,1,2010,24,98,68,190
Oromia,Guji,Adola Town,Megabit,7,2009,63,54,27,144
Oromia,West Wellega,Lalo Asabi,Teqemt,2,2011,7,3,18,28
Oromia,Dukem Town,Dukem Town,Miyazia,8,2010,79,35,91,205
Oromia,Jimma,Limu Kosa,Yekatit,6,2009,72,77,62,211
Oromia,East Hararge,Gursum,Hedar,3,2010,74,16,61,151
Oromia,West Guji,Hanbala,Megabit,7,2011,1,13,8,22
Oromia,Guji,Aga Wayyu,Nehase,12,2010,44,45,33,122
Oromia,Qeleme Wellega,Hawa Gelan,Tahesas,4,2010,69,13,47,129
Oromia,Buno Bedele,Dedesa,Megabit,7,2011,86,6,52,144
Oromia,Qeleme Wellega,Dale Wabera,Yekatit,6,2010,3,55,66,124
Oromia,East Wellega,Boneya Bushe,Nehase,12,2010,43,20,96,159
Oromia,Guji,Dima,Ginbot,9,2010,90,83,36,209
Oromia,North Shewa,Hidabu Abote,Miyazia,8,2010,42,62,93,197
Oromia,Guji,Gumi Eldallo,Miyazia,8,2010,17,81,72,170
Oromia,East Wellega,Ebantu,Ginbot,9,2010,2,6,66,74
Oromia,Nekemte Town,Nekemte Town,Miyazia,8,2011,4,94,69,167
Oromia,West Hararge,Burka Dimtu,Miyazia,8,2011,92,17,65,174
Oromia,East Hararge,Bisidimo Hospital,Nehase,12,2010,25,35,79,139
Oromia,West Wellega,Boji Cheqorsa,Yekatit,6,2011,50,46,70,166
Oromia,Arsi,Bale Gesgara,Tir,5,2009,91,77,45,213
Oromia,Borena,Yabelo Rural,Meskerem,1,2010,53,59,76,188
Oromia,Qeleme Wellega,Hawa Gelan,Tir,5,2010,78,32,21,131
Oromia,Bale,Robe Town,Meskerem,1,2010,94,70,18,182
Oromia,East Hararge,Bisidimo Hospital,Ginbot,9,2009,29,28,46,103
Oromia,Jimma,Dedo,Megabit,7,2010,6,16,82,104
Oromia,Jimma,Limu Hospital,Megabit,7,2011,47,19,68,134
Oromia,Horo Gudru Wellega,Horo,Sene,10,2009,31,16,37,84
Oromia,Jimma,Limu Seka,Yekatit,6,2010,46,37,49,132
Oromia,Qeleme Wellega,Kake Hosp,Tir,5,2011,85,1,71,157
Oromia,North Shewa,Debre Libanos,Hedar,3,2010,77,27,50,154
Oromia,Horo Gudru Wellega,Abay Chomen,Tahesas,4,2011,58,54,69,181
Oromia,Burayu Town,Burayu Town,Megabit,7,2009,80,51,91,222
Oromia,East Shewa,Adama,Megabit,7,2011,50,17,66,133
Oromia,West Hararge,Hawi Gudina,Ginbot,9,2009,8,61,16,85
Oromia,East Hararge,Girawa,Hedar,3,2010,60,32,2,94
Oromia,Jimma,Limu Hospital,Teqemt,2,2011,5,28,45,78
Oromia,West Wellega,Lalo Asabi,Miyazia,8,2011,65,20,92,177
Oromia,West Arsi,Nensebo,Ginbot,9,2010,56,14,44,114
Oromia,South West Shewa,Wonchi,Yekatit,6,2009,22,7,9,38
Oromia,North Shewa,Jido,Ginbot,9,2010,28,15,21,64
Oromia,West Hararge,Boke,Hamle,11,2010,47,76,1,124
Oromia,Jimma,Sigmo,Meskerem,1,2011,92,54,72,218
Oromia,North Shewa,Wuchale,Megabit,7,2010,46,27,0,73
Oromia,Bale,Ginir Town,Tahesas,4,2011,37,76,92,205
Oromia,Guji,Adola Town,Miyazia,8,2010,38,5,91,134
Oromia,Jimma Spe Town,Jimma Spe Town,Tir,5,2009,71,79,58,208
Oromia,South West Shewa,Tole,Tir,5,2009,4,17,22,43
Oromia,West Hararge,Daro Lebu,Tir,5,2009,78,74,57,209
Oromia,West Arsi,Arsi Negele Rural,Tir,5,2010,58,34,47,139
Oromia,Borena,Dubluk,Ginbot,9,2009,67,19,33,119
Oromia,Qeleme Wellega,Hawa Gelan Hosp,Sene,10,2011,84,6,81,171
Oromia,West Guji,Bule Hora Toun,Yekatit,6,2009,20,29,62,111
Oromia,Arsi,Shenan Kolu,Hedar,3,2010,93,73,6,172
Oromia,Buno Bedele,Meko,Yekatit,6,2011,71,88,31,190
Oromia,Guji,Liben,Meskerem,1,2011,43,37,97,177
Oromia,East Shewa,Mojo,Hamle,11,2009,41,33,14,88
Oromia,Qeleme Wellega,Dale Sedi,Ginbot,9,2010,14,89,86,189
Oromia,Jimma,Limu Seka,Nehase,12,2010,97,62,52,211
Oromia,West Wellega,Nole Kaba,Miyazia,8,2010,75,71,32,178
Oromia,Arsi,Zeway Dugda,Nehase,12,2010,41,31,58,130
Oromia,North Shewa,Abichugna,Hamle,11,2009,72,79,53,204
Oromia,Adama Special Town,Adama Town,Yekatit,6,2011,19,27,14,60
Oromia,East Shewa,Mojo,Megabit,7,2009,84,76,37,197
Oromia,West Shewa,Ejerie,Sene,10,2009,0,39,20,59
Oromia,West Wellega,Gimbi Rural,Nehase,12,2010,43,6,38,87
Oromia,Jimma,Gomma,Meskerem,1,2010,82,24,32,138
Oromia,West Arsi,Bishan Guracha Town,Miyazia,8,2009,37,12,15,64
Oromia,West Arsi,Dodola Rural,Hamle,11,2009,60,2,57,119
Oromia,East Hararge,Bisidimo Hospital,Hamle,11,2009,18,52,50,120
Oromia,Ilu Aba Bora,Darimu,Ginbot,9,2011,73,45,17,135
Oromia,Qeleme Wellega,Hawa Gelan,Tir,5,2011,55,59,50,164
Oromia,North Shewa,Were Jarso,Miyazia,8,2010,35,39,97,171
Oromia,Jimma,Sekoru,Megabit,7,2011,91,34,28,153
Oromia,North Shewa,Hidabu Abote,Tir,5,2011,41,92,84,217
Oromia,West Wellega,Boji Dermeji,Yekatit,6,2011,12,6,45,63
Oromia,West Arsi,Kofele,Meskerem,1,2010,22,82,17,121
Oromia,Borena,Yabelo,Megabit,7,2010,36,99,92,227
Oromia,West Arsi,Bishan Guracha Town,Miyazia,8,2009,97,70,58,225
Oromia,West Shewa,Ambo Town,Tir,5,2009,65,10,4,79
Oromia,East Shewa,Fentale,Megabit,7,2010,81,52,6,139
Oromia,West Shewa,Jeldu,Tir,5,2010,87,75,79,241
Oromia,West Shewa,Ambo,Hamle,11,2010,73,22,38,133
Oromia,Arsi,Munesa,Tahesas,4,2011,73,9,39,121
Oromia,West Hararge,Gemechis,Tir,5,2011,56,7,61,124
Oromia,West Shewa,Dano,Tahesas,4,2010,39,37,26,102
Oromia,Qeleme Wellega,Hawa Gelan,Meskerem,1,2011,26,70,48,144
Oromia,Arsi,Gololcha,Yekatit,6,2011,36,39,18,93
Oromia,West Shewa,Gindeberet Hospital,Meskerem,1,2010,46,91,17,154
Oromia,Jimma,Setema,Ginbot,9,2009,71,0,4,75
Oromia,West Wellega,Gimbi,Yekatit,6,2009,76,92,36,204
Oromia,West Guji,Biebirsa Kojowa,Ginbot,9,2010,1,15,48,64
Oromia,Arsi,Digeluna Tijo,Nehase,12,2010,92,38,66,196
Oromia,Bale,Meda Welabu,Ginbot,9,2009,98,75,16,189
Oromia,Ilu Aba Bora,Nono Sele,Nehase,12,2010,24,23,16,63
Oromia,North Shewa,Girar Jarso,Ginbot,9,2009,24,17,34,75
Oromia,North Shewa,Girar Jarso,Yekatit,6,2010,34,22,40,96
Oromia,West Wellega,Boji Dermeji,Sene,10,2011,91,44,3,138
Oromia,East Hararge,Deder Hospital,Meskerem,1,2010,26,19,1,46
Oromia,Horo Gudru Wellega,Horro Buluk,Hamle,11,2010,31,47,93,171
Oromia,Horo Gudru Wellega,Gudru,Ginbot,9,2011,71,82,23,176
Oromia,Qeleme Wellega,Dale Sedi,Nehase,12,2010,49,2,56,107
Oromia,West Guji,Bule Hora Toun,Megabit,7,2011,55,13,71,139
Oromia,West Arsi,Kokosa  Hospital,Ginbot,9,2010,10,17,3,30
Oromia,West Shewa,Ejerie,Hedar,3,2010,97,75,99,271
Oromia,East Hararge,Kersa Eh,Megabit,7,2009,27,35,8,70
Oromia,East Hararge,Kersa Eh,Hedar,3,2010,75,37,76,188
Oromia,Arsi,Sude,Tahesas,4,2011,93,12,24,129
Oromia,Finfine Zuria,Sululta Town,Nehase,12,2009,30,16,89,135
Oromia,Buno Bedele,Boricha,Hamle,11,2010,64,96,77,237
Oromia,East Hararge,Midega Tole,Hamle,11,2010,14,2,65,81
Oromia,East Hararge,Garemuleta Hospital,Miyazia,8,2011,7,85,14,106
Oromia,Horo Gudru Wellega,Horro Buluk,Miyazia,8,2011,60,15,95,170
Oromia,West Shewa,Ambo,Megabit,7,2009,79,57,8,144
Oromia,East Shewa,Matahara,Megabit,7,2010,5,41,36,82
Oromia,Shashamane Town,Shashamane Town,Megabit,7,2010,11,5,90,106
Oromia,West Guji,Kercha Hospital,Nehase,12,2010,69,90,19,178
Oromia,East Hararge,Kersa Eh,Miyazia,8,2011,96,46,20,162
Oromia,West Arsi,Gambo Hospital,Sene,10,2011,43,73,72,188
Oromia,West Shewa,Ilu Galan,Sene,10,2011,31,89,42,162
Oromia,Lege Dadi Lege Tafo Town,Lege Dadi Lege Tafo Town,Sene,10,2009,91,62,5,158
Oromia,East Wellega,Gobu Seyo,Tir,5,2011,27,42,55,124
Oromia,Qeleme Wellega,Anfilo,Ginbot,9,2011,96,19,15,130
Oromia,Bale,Arena Buluq,Miyazia,8,2010,66,36,13,115
Oromia,Qeleme Wellega,Dambi Dollo,Nehase,12,2010,85,6,5,96
Oromia,Guji,Hambela Wamena,Hamle,11,2009,90,7,98,195
Oromia,West Wellega,Gimbi Public  Hospital,Meskerem,1,2010,96,98,85,279
Oromia,Bale,Seweyna,Miyazia,8,2010,7,83,2,92
Oromia,East Hararge,Haromaya Hospital,Yekatit,6,2009,24,29,60,113
Oromia,Guji,Saba Boru,Hedar,3,2011,59,30,4,93
Oromia,East Hararge,Midega Tole,Ginbot,9,2010,20,6,79,105
Oromia,West Shewa,Jibat,Tir,5,2010,92,58,44,194
Oromia,West Shewa,Ejersa Lafo,Miyazia,8,2009,17,38,50,105
Oromia,Jimma,Limu Hospital,Yekatit,6,2009,94,62,96,252
Oromia,West Shewa,Midakegni,Teqemt,2,2011,81,6,49,136
Oromia,Gelan Town,Gelan Town,Megabit,7,2011,80,95,46,221
Oromia,Borena,Moyale Hospital,Megabit,7,2011,36,61,8,105
Oromia,Bale,Robe Town,Yekatit,6,2009,99,92,83,274
Oromia,South West Shewa,Tole,Megabit,7,2010,34,48,0,82
Oromia,South West Shewa,Dawo,Miyazia,8,2010,17,93,83,193
Oromia,North Shewa,Wuchale,Miyazia,8,2010,5,60,48,113
Oromia,West Arsi,Shala,Tahesas,4,2011,47,67,12,126
Oromia,West Shewa,Metarobi,Tir,5,2009,57,77,39,173
Oromia,Bale,Sinana,Tahesas,4,2011,82,33,81,196
Oromia,South West Shewa,Dawo,Teqemt,2,2010,24,4,34,62
Oromia,West Shewa,Tikur Enchini,Miyazia,8,2010,28,25,30,83
Oromia,Arsi,Merti,Hamle,11,2009,34,72,82,188
Oromia,Jimma,Gera,Nehase,12,2009,41,44,65,150
Oromia,East Hararge,Chinakesen,Hedar,3,2011,87,12,32,131
Oromia,East Wellega,Diga,Tahesas,4,2011,75,99,47,221
Oromia,Qeleme Wellega,Dale Sedi,Tir,5,2011,43,86,20,149
Oromia,Jimma,Mancho,Sene,10,2009,96,79,1,176
Oromia,West Shewa,Midakegni,Tir,5,2011,29,77,29,135
Oromia,Jimma,Shabe,Yekatit,6,2010,5,13,87,105
Oromia,Bale,Meda Welabu,Megabit,7,2009,74,11,12,97
Oromia,East Hararge,Jarso,Meskerem,1,2011,78,92,7,177
Oromia,West Wellega,Boji Dermeji,Ginbot,9,2009,3,45,72,120
Oromia,Horo Gudru Wellega,Shambu Town,Teqemt,2,2011,18,94,65,177
Oromia,Bale,Seweyna,Tir,5,2011,9,24,48,81
Oromia,Bale,Legehida,Yekatit,6,2010,64,49,35,148
Oromia,Buno Bedele,Bedele Town,Yekatit,6,2011,69,7,92,168
Oromia,Bale,Dawe Qachen,Megabit,7,2010,92,83,94,269
Oromia,Ambo Town,Ambo Town,Miyazia,8,2010,19,39,4,62
Oromia,South West Shewa,Kersana Malima,Meskerem,1,2011,15,49,67,131
Oromia,West Wellega,Homa,Tahesas,4,2011,21,40,56,117
Oromia,East Shewa,Lomme,Meskerem,1,2010,80,19,63,162
Oromia,Guji,Gumi Eldallo,Nehase,12,2009,33,50,60,143
Oromia,Gelan Town,Gelan Town,Ginbot,9,2011,73,8,65,146
Oromia,Bale,Goba,Megabit,7,2009,6,87,89,182
Oromia,Finfine Zuria,Sebeta Awas,Nehase,12,2009,97,83,82,262
Oromia,West Shewa,Inchini Hospital,Tir,5,2011,86,40,14,140
Oromia,East Wellega,Boneya Bushe,Ginbot,9,2009,4,50,37,91
Oromia,West Hararge,Doba,Yekatit,6,2009,88,5,43,136
Oromia,Ilu Aba Bora,Halu,Tahesas,4,2010,41,75,57,173
Oromia,West Wellega,Qiltu Kara,Miyazia,8,2010,59,6,33,98
Oromia,West Hararge,Mesela,Sene,10,2009,80,40,56,176
Oromia,West Wellega,Mendi Town,Sene,10,2010,41,81,89,211
Oromia,Jimma,B/Tolyi,Megabit,7,2011,68,67,25,160
Oromia,West Hararge,Oda Bultum,Meskerem,1,2010,87,10,23,120
Oromia,West Guji,Bule Hora,Miyazia,8,2009,98,78,33,209
Oromia,West Guji,Biebirsa Kojowa,Ginbot,9,2010,93,23,45,161
Oromia,West Guji,Mkelka Soda,Teqemt,2,2010,49,27,36,112
Oromia,West Wellega,Babo Gembel,Miyazia,8,2010,60,19,83,162
Oromia,West Arsi,Gambo Hospital,Yekatit,6,2010,43,25,8,76
Oromia,Horo Gudru Wellega,Amuru,Tir,5,2011,46,5,46,97
Oromia,North Shewa,Degem,Nehase,12,2009,44,62,99,205
Oromia,Arsi,Digeluna Tijo,Nehase,12,2009,98,20,27,145
Oromia,Finfine Zuria,Berreh,Miyazia,8,2011,1,44,40,85
Oromia,Borena,Dilo,Miyazia,8,2009,92,84,19,195
Oromia,Ilu Aba Bora,Doreni,Megabit,7,2009,25,44,34,103
Oromia,West Shewa,Tibe Kutaye,Sene,10,2011,94,9,59,162
Oromia,East Hararge,Jarso,Tahesas,4,2011,5,94,19,118
Oromia,East Wellega,Gobu Seyo,Sene,10,2010,68,93,44,205
Oromia,Jimma,Tiro Afeta,Nehase,12,2010,35,83,85,203
Oromia,West Wellega,Qiltu Kara,Teqemt,2,2010,72,4,63,139
Oromia,West Wellega,Mendi Town,Megabit,7,2009,52,72,64,188
Oromia,Arsi,Aseko,Yekatit,6,2011,33,1,72,106
Oromia,West Wellega,Mene Sibu,Tir,5,2010,43,55,4,102
Oromia,North Shewa,Yaya Gulele,Ginbot,9,2009,34,7,28,69
Oromia,East Wellega,Haro Limu,Tahesas,4,2010,53,26,2,81
Oromia,Jimma Spe Town,Jimma Spe Town,Yekatit,6,2010,32,56,10,98
Oromia,Ilu Aba Bora,Doreni,Nehase,12,2010,83,10,3,96
Oromia,West Wellega,Qiltu Kara,Ginbot,9,2010,49,18,36,103
Oromia,Guji,Anna Sora,Ginbot,9,2011,41,25,6,72
Oromia,West Hararge,Hawi Gudina,Tahesas,4,2011,17,49,87,153
Oromia,West Hararge,Bedesa Town,Sene,10,2009,67,50,51,168
Oromia,North Shewa,Kuyu,Megabit,7,2010,94,57,82,233
Oromia,East Wellega,Diga,Hedar,3,2011,65,49,15,129
Oromia,West Hararge,Mesela,Ginbot,9,2010,11,65,55,131
Oromia,Finfine Zuria,Walmera,Teqemt,2,2011,33,17,27,77
Oromia,Arsi,Dodota,Miyazia,8,2010,56,12,5,73
Oromia,Arsi,Jeju,Nehase,12,2009,33,1,92,126
Oromia,Bale,Dinsho,Miyazia,8,2010,85,30,78,193
Oromia,West Guji,Kercha Hospital,Meskerem,1,2010,45,92,79,216
Oromia,East Hararge,Garemuleta Hospital,Tir,5,2011,32,19,41,92
Oromia,Horo Gudru Wellega,Hababo Guduru,Hedar,3,2010,79,49,62,190
Oromia,Borena,Dhas,Yekatit,6,2010,25,12,6,43
Oromia,South West Shewa,Bantu  Hospital,Tir,5,2011,49,64,87,200
Oromia,Arsi,Hitosa,Ginbot,9,2011,45,3,96,144
Oromia,West Wellega,Nejo Hospital,Sene,10,2010,7,99,14,120
Oromia,Arsi,Dodota,Sene,10,2011,17,10,70,97
Oromia,East Wellega,Gudeyabila,Nehase,12,2009,62,31,23,116
Oromia,Bale,Gasera,Nehase,12,2009,65,12,61,138
Oromia,East Wellega,Sasiga,Miyazia,8,2009,19,39,30,88
Oromia,Qeleme Wellega,Yemalogi Wolel,Meskerem,1,2010,89,9,57,155
Oromia,Ilu Aba Bora,Metu Rural,Nehase,12,2009,49,79,19,147
Oromia,East Hararge,Midega Tole,Ginbot,9,2010,12,19,30,61
Oromia,East Wellega,Kiremu,Tir,5,2009,21,85,55,161
Oromia,Guji,Goro Dola,Teqemt,2,2011,65,66,20,151
Oromia,West Hararge,Meiso,Sene,10,2009,34,13,21,68
Oromia,West Shewa,Inchini Hospital,Ginbot,9,2011,57,92,42,191
Oromia,North Shewa,Kuyu Hospital,Miyazia,8,2010,93,17,62,172
Oromia,Arsi,Sire,Megabit,7,2010,53,23,39,115
Oromia,West Wellega,Haru,Megabit,7,2010,40,31,72,143
Oromia,West Wellega,Ayira,Ginbot,9,2010,95,12,23,130
Oromia,Borena,Arero,Tahesas,4,2010,2,55,36,93
Oromia,Guji,Bore,Yekatit,6,2010,60,92,8,160
Oromia,West Arsi,Bishan Guracha Town,Meskerem,1,2010,39,57,83,179
Oromia,Bale,Seweyna,Tahesas,4,2011,72,58,6,136
Oromia,West Shewa,Ambo Hospital,Hedar,3,2010,52,42,82,176
Oromia,Guji,Shakiso Town,Meskerem,1,2011,42,43,21,106
Oromia,West Wellega,Mendi Town,Yekatit,6,2010,9,65,76,150
Oromia,Jimma,B/Tolyi,Nehase,12,2009,44,93,20,157
Oromia,Borena,Arero,Sene,10,2010,54,53,97,204
Oromia,Arsi,Sire,Hamle,11,2009,65,42,2,109
Oromia,Arsi,Ludehetosa,Sene,10,2011,96,84,32,212
Oromia,Bale,Dawe Serar,Teqemt,2,2010,75,43,25,143
Oromia,Guji,Shakiso Town,Miyazia,8,2011,35,52,64,151
Oromia,Buno Bedele,Chora,Ginbot,9,2010,49,59,99,207
Oromia,West Arsi,Gedeb Asasa,Nehase,12,2010,38,84,34,156
Oromia,Borena,Yabelo,Ginbot,9,2010,53,16,86,155
Oromia,Ilu Aba Bora,Metu Rural,Yekatit,6,2010,32,21,56,109
Oromia,West Shewa,Tibe Kutaye,Sene,10,2009,49,60,76,185
Oromia,South West Shewa,Kersana Malima,Tir,5,2010,88,49,45,182
Oromia,Lege Dadi Lege Tafo Town,Lege Dadi Lege Tafo Town,Miyazia,8,2010,9,57,22,88
Oromia,West Hararge,Daro Lebu,Hedar,3,2010,84,91,92,267
Oromia,Jimma,Agaro,Tir,5,2009,83,9,1,93
Oromia,Guji,Wadara,Hedar,3,2010,85,72,29,186
Oromia,East Hararge,Deder Town,Ginbot,9,2011,5,94,17,116
Oromia,Arsi,Bale Gesgara,Hamle,11,2009,15,59,87,161
Oromia,Jimma Spe Town,Jimma Spe Town,Meskerem,1,2010,81,54,85,220
Oromia,Horo Gudru Wellega,Gudru,Tahesas,4,2011,48,6,4,58
Oromia,Borena,Wachile,Tir,5,2011,16,48,15,79
Oromia,West Hararge,Anchar,Hedar,3,2011,64,28,52,144
Oromia,West Wellega,Boji Dermeji,Hamle,11,2010,36,65,74,175
Oromia,West Wellega,Ayira,Sene,10,2009,11,85,71,167
Oromia,Bale,Delo Mena,Tir,5,2010,34,92,29,155
Oromia,West Wellega,Haru,Nehase,12,2010,72,60,45,177
Oromia,Buno Bedele,Meko,Hedar,3,2011,61,53,65,179
Oromia,East Hararge,Chinakesen,Ginbot,9,2011,39,3,23,65
Oromia,Horo Gudru Wellega,Gudru,Megabit,7,2010,70,14,15,99
Oromia,Modjo Town,Modjo Town,Hedar,3,2011,99,16,55,170
Oromia,East Hararge,Meyu Muleke,Meskerem,1,2011,86,92,53,231
Oromia,East Shewa,Mojo,Ginbot,9,2009,90,75,14,179
Oromia,Qeleme Wellega,Anfilo,Yekatit,6,2009,5,80,64,149
Oromia,West Wellega,Gimbi,Ginbot,9,2011,57,47,8,112
Oromia,Jimma,O/Beyam,Teqemt,2,2011,17,6,86,109
Oromia,Arsi,Seru,Yekatit,6,2011,85,39,39,163
Oromia,East Hararge,Deder Hospital,Sene,10,2009,62,60,66,188
Oromia,South West Shewa,Ameya,Megabit,7,2009,95,56,8,159
Oromia,Arsi,Jeju,Ginbot,9,2011,64,95,30,189
Oromia,Burayu Town,Burayu Town,Ginbot,9,2010,7,5,61,73
Oromia,West Arsi,Siraro,Nehase,12,2010,77,25,21,123
Oromia,North Shewa,Jido,Sene,10,2011,61,87,53,201
Oromia,Qeleme Wellega,Hawa Gelan,Nehase,12,2009,70,86,21,177
Oromia,Holeta Town,Holeta Town,Megabit,7,2010,89,62,79,230
Oromia,Ilu Aba Bora,Metu Town,Sene,10,2010,13,9,2,24
Oromia,Gelan Town,Gelan Town,Tahesas,4,2011,25,13,21,59
Oromia,West Arsi,Siraro,Tir,5,2010,58,57,31,146
Oromia,East Shewa,Adea,Hedar,3,2011,0,78,42,120
Oromia,East Hararge,Girawa,Yekatit,6,2009,54,40,26,120
Oromia,East Wellega,Leqa Dulecha,Hedar,3,2010,91,93,50,234
Oromia,Bale,Meda Welabu,Nehase,12,2010,85,38,73,196
Oromia,West Hararge,Oda Bultum,Yekatit,6,2009,25,55,95,175
Oromia,North Shewa,Dera Hospital,Ginbot,9,2009,11,81,94,186
Oromia,East Shewa,Adama,Miyazia,8,2011,68,3,13,84
Oromia,East Shewa,Olanciti Hospital,Meskerem,1,2010,54,78,13,145
Oromia,Guji,Saba Boru,Sene,10,2009,2,32,85,119
Oromia,West Wellega,Ayira Hospital,Nehase,12,2009,46,63,7,116
Oromia,Jimma,Dedo,Miyazia,8,2011,6,12,78,96
Oromia,West Shewa,Abuna Gindeberet,Megabit,7,2010,9,4,18,31
Oromia,Jimma,Limu Kosa,Ginbot,9,2010,75,47,25,147
Oromia,Qeleme Wellega,Dambi Dolo Hospital,Meskerem,1,2011,91,11,55,157
Oromia,Horo Gudru Wellega,Gudru,Hedar,3,2010,49,18,3,70
Oromia,West Arsi,Arsi Negele Town,Nehase,12,2010,76,61,80,217
Oromia,Borena,Dire,Tir,5,2010,77,63,4,144
Oromia,North Shewa,Abichugna,Tir,5,2011,15,92,14,121
Oromia,East Hararge,Bisidimo Hospital,Tir,5,2011,8,17,37,62
Oromia,North Shewa,Girar Jarso,Miyazia,8,2010,69,48,24,141
Oromia,Arsi,Limuna Bilbilo,Ginbot,9,2011,69,93,84,246
Oromia,Buno Bedele,Meko,Ginbot,9,2009,12,99,39,150
Oromia,Arsi,Ludehetosa,Nehase,12,2009,68,24,70,162
Oromia,Horo Gudru Wellega,Shambu Town,Ginbot,9,2009,58,8,34,100
Oromia,West Wellega,Begi,Tahesas,4,2010,32,91,38,161
Oromia,West Shewa,Tikur Enchini,Hamle,11,2009,86,48,60,194
Oromia,North Shewa,Abichugna,Nehase,12,2010,40,67,7,114
Oromia,West Shewa,Tikur Enchini,Megabit,7,2009,28,87,66,181
Oromia,West Guji,Gelana,Hamle,11,2009,13,55,22,90
Oromia,West Wellega,Lalo Asabi,Meskerem,1,2010,11,6,83,100
Oromia,North Shewa,Debre Libanos,Teqemt,2,2011,74,68,86,228
Oromia,North Shewa,Girar Jarso,Tahesas,4,2011,67,68,62,197
Oromia,Finfine Zuria,Akaki,Hedar,3,2010,54,28,82,164
Oromia,West Wellega,Kundala,Yekatit,6,2011,12,90,62,164
Oromia,East Hararge,Jarso,Megabit,7,2009,20,50,26,96
Oromia,Borena,Yabelo Hospital,Hamle,11,2009,60,11,21,92
Oromia,Woliso Town,Woliso Town,Meskerem,1,2011,48,27,59,134
Oromia,West Shewa,Abuna Gindeberet,Tahesas,4,2010,48,58,95,201
Oromia,West Shewa,Guder Hosp,Tahesas,4,2010,98,27,90,215
Oromia,Ilu Aba Bora,Metu Rural,Meskerem,1,2011,12,57,66,135
Oromia,Qeleme Wellega,Kake Hosp,Megabit,7,2011,23,91,77,191
Oromia,North Shewa,Hidabu Abote,Sene,10,2009,78,90,81,249
Oromia,Horo Gudru Wellega,Hababo Guduru,Megabit,7,2010,55,19,31,105
Oromia,Bale,Sinana,Nehase,12,2009,34,55,54,143
Oromia,West Wellega,Begi,Meskerem,1,2011,11,9,56,76
Oromia,Jimma,Sekoru,Megabit,7,2010,21,47,87,155
Oromia,Qeleme Wellega,Dambi Dollo,Ginbot,9,2011,10,86,3,99
Oromia,West Guji,Suro Barguda,Tahesas,4,2011,7,45,20,72
Oromia,West Wellega,Gimbi,Tir,5,2010,57,60,84,201
Oromia,Finfine Zuria,Akaki,Miyazia,8,2009,5,6,29,40
Oromia,East Hararge,Girawa,Meskerem,1,2010,38,92,16,146
Oromia,North Shewa,Dera,Sene,10,2009,54,88,23,165
Oromia,West Arsi,Dodola Rural,Sene,10,2010,18,36,97,151
Oromia,Guji,Gumi Eldallo,Megabit,7,2011,71,37,95,203
Oromia,East Hararge,Bedeno,Sene,10,2009,80,85,65,230
Oromia,West Hararge,Mesela,Hamle,11,2010,42,36,0,78
Oromia,West Wellega,Gimbi,Ginbot,9,2011,58,7,85,150
Oromia,West Hararge,Bedesa Town,Yekatit,6,2010,0,0,15,15
Oromia,Guji,Anna Sora,Meskerem,1,2011,71,20,94,185
Oromia,Arsi,Enkelo Wabe,Miyazia,8,2011,62,69,34,165
Oromia,Arsi,Chole,Ginbot,9,2011,28,3,40,71
Oromia,East Hararge,Gursum,Megabit,7,2009,14,69,56,139
Oromia,Bale,Delo Mena,Sene,10,2009,36,3,64,103
Oromia,Qeleme Wellega,Dambi Dollo,Ginbot,9,2011,58,49,74,181
Oromia,Guji,Gumi Eldallo,Hamle,11,2010,67,29,22,118
Oromia,South West Shewa,Woliso Rural,Hamle,11,2010,44,35,34,113
Oromia,West Hararge,Burka Dimtu,Hedar,3,2010,13,12,4,29
Oromia,West Wellega,Mendi Town,Hedar,3,2010,46,49,8,103
Oromia,West Shewa,Jibat,Sene,10,2009,32,5,76,113
Oromia,East Wellega,Gobu Seyo,Tir,5,2010,57,67,31,155
Oromia,East Wellega,Gida Ayana,Miyazia,8,2011,47,95,26,168
Oromia,Finfine Zuria,Sululta Town,Hedar,3,2010,89,40,22,151
Oromia,West Guji,Bule Hora Hospital,Megabit,7,2010,1,24,79,104
Oromia,Borena,Teltele,Sene,10,2009,63,69,37,169
Oromia,Qeleme Wellega,Anfilo,Hedar,3,2010,42,30,1,73
Oromia,Bale,Ginir,Miyazia,8,2010,68,59,52,179
Oromia,West Shewa,Liban Jawi,Ginbot,9,2009,4,0,52,56
Oromia,Arsi,Hitosa,Ginbot,9,2010,87,99,90,276
Oromia,Bale,Ginir Town,Hamle,11,2009,82,37,85,204
Oromia,Arsi,Robe,Nehase,12,2009,11,50,80,141
Oromia,East Shewa,Olanciti Hospital,Nehase,12,2010,92,9,46,147
Oromia,East Shewa,Adami Tulu Jido Kombolcha,Sene,10,2010,13,76,87,176
Oromia,Bale,Meda Welabu,Sene,10,2009,23,73,21,117
Oromia,East Shewa,Fentale,Megabit,7,2009,61,85,17,163
Oromia,Horo Gudru Wellega,Horro Buluk,Megabit,7,2011,80,71,92,243
Oromia,West Wellega,Homa,Nehase,12,2010,75,58,17,150
Oromia,West Arsi,Loke Hada Hospital,Miyazia,8,2011,59,38,42,139
Oromia,West Wellega,Ayira Hospital,Tahesas,4,2010,70,80,9,159
Oromia,East Shewa,Liben,Ginbot,9,2010,59,16,75,150
Oromia,West Shewa,Meta Waliqite,Ginbot,9,2010,47,33,8,88
Oromia,Finfine Zuria,Sandefa,Nehase,12,2010,73,62,79,214
Oromia,Guji,Aga Wayyu,Nehase,12,2009,38,31,54,123
Oromia,Finfine Zuria,Sandefa,Hamle,11,2009,66,10,96,172
Oromia,Bale,Meda Welabu,Hedar,3,2011,71,61,19,151
Oromia,West Shewa,Guder Hosp,Hamle,11,2009,15,43,3,61
Oromia,West Shewa,Gedo Hospital,Hedar,3,2010,64,12,97,173
Oromia,West Wellega,Ayira,Teqemt,2,2010,58,82,68,208
Oromia,Borena,El Way,Miyazia,8,2010,75,29,75,179
Oromia,West Hararge,Habro,Hamle,11,2010,7,30,43,80
Oromia,West Arsi,Loke Hada Hospital,Miyazia,8,2011,51,43,15,109
Oromia,West Arsi,Kokosa  Hospital,Megabit,7,2010,50,82,65,197
Oromia,Jimma,O/Beyam,Nehase,12,2010,52,27,34,113
Oromia,East Shewa,Dugda,Sene,10,2009,26,52,69,147
Oromia,Ilu Aba Bora,Halu,Nehase,12,2010,81,6,10,97
Oromia,Holeta Town,Holeta Town,Miyazia,8,2010,55,25,51,131
Oromia,Arsi,Digeluna Tijo,Hedar,3,2010,83,38,65,186
Oromia,East Hararge,Goro Muti,Ginbot,9,2010,73,93,92,258
Oromia,East Shewa,Lomme,Tahesas,4,2010,71,19,31,121
Oromia,East Wellega,Gobu Seyo,Miyazia,8,2009,62,25,48,135
Oromia,West Guji,Biebirsa Kojowa,Yekatit,6,2009,22,62,25,109
Oromia,Jimma,Sigmo,Hamle,11,2010,85,82,93,260
Oromia,West Wellega,Seyo Nole,Megabit,7,2010,77,5,5,87
Oromia,Borena,Meyo,Hedar,3,2010,90,50,26,166
Oromia,Jimma,Shabe,Miyazia,8,2011,85,34,53,172
Oromia,West Guji,Bule Hora Toun,Yekatit,6,2009,50,53,90,193
Oromia,Buno Bedele,Diga,Miyazia,8,2010,28,10,92,130
Oromia,Guji,Hambela Wamena,Miyazia,8,2010,49,84,71,204
Oromia,East Hararge,Bedeno,Hamle,11,2009,89,85,57,231
Oromia,Bale,Dawe Qachen,Ginbot,9,2009,94,75,68,237
Oromia,West Shewa,Bako Tibe,Miyazia,8,2009,93,87,80,260
Oromia,Qeleme Wellega,Sedan Chanka,Meskerem,1,2011,61,57,35,153
Oromia,West Wellega,Gimbi Rural,Megabit,7,2010,99,30,10,139
Oromia,West Wellega,Nejo Rural,Yekatit,6,2010,83,4,77,164
Oromia,North Shewa,Were Jarso,Miyazia,8,2011,75,21,82,178
Oromia,West Shewa,Inchini Hospital,Tir,5,2011,58,6,58,122
Oromia,Jimma,Limu Hospital,Sene,10,2011,51,61,4,116
Oromia,West Arsi,Loke Hada Hospital,Megabit,7,2011,75,42,46,163
Oromia,West Guji,Hanbala,Sene,10,2010,30,38,70,138
Oromia,East Wellega,Diga,Nehase,12,2009,76,32,48,156
Oromia,South West Shewa,Ameya Hospital,Miyazia,8,2010,32,55,30,117
Oromia,West Shewa,Ginde Beret,Megabit,7,2010,5,82,25,112
Oromia,Buno Bedele,Meko,Ginbot,9,2010,59,93,28,180
Oromia,Buno Bedele,Gechi,Megabit,7,2010,41,39,69,149
Oromia,West Hararge,Meiso,Meskerem,1,2010,15,71,11,97
Oromia,West Shewa,Ambo,Sene,10,2010,92,32,69,193
Oromia,Borena,Gomole,Tir,5,2011,50,43,48,141
Oromia,West Wellega,Kundala,Hamle,11,2009,45,19,28,92
Oromia,South West Shewa,Becho,Ginbot,9,2009,17,26,39,82
Oromia,East Wellega,Gida Ayana,Hedar,3,2011,10,13,25,48
Oromia,West Arsi,Kokosa,Tahesas,4,2010,6,59,58,123
Oromia,West Guji,Hanbala,Ginbot,9,2011,9,47,35,91
Oromia,Bale,Goro,Nehase,12,2010,72,43,54,169
Oromia,Buno Bedele,Bedele Hospital,Ginbot,9,2010,90,53,1,144
Oromia,West Wellega,Homa,Hedar,3,2011,88,74,73,235
Oromia,South West Shewa,Ameya,Yekatit,6,2010,87,63,84,234
Oromia,Arsi,Gololcha,Meskerem,1,2010,68,53,61,182
Oromia,East Wellega,Ebantu,Meskerem,1,2010,49,15,8,72
Oromia,West Hararge,Chiro Zuriya,Hedar,3,2011,24,22,16,62
Oromia,West Wellega,Nole Kaba,Nehase,12,2010,52,28,87,167
Oromia,East Shewa,Liben,Hamle,11,2010,88,92,49,229
Oromia,East Wellega,Guto Gida,Miyazia,8,2011,4,84,60,148
Oromia,Qeleme Wellega,Jimma Horo,Teqemt,2,2011,54,17,66,137
Oromia,Qeleme Wellega,Dambi Dolo Hospital,Sene,10,2010,91,1,47,139
Oromia,East Hararge,Babile,Hamle,11,2009,60,86,17,163
Oromia,Arsi,Zeway Dugda,Tir,5,2009,36,68,90,194
Oromia,West Wellega,Mendi Hospital,Megabit,7,2009,32,32,77,141
Oromia,Jimma,Nono Benja,Meskerem,1,2011,37,29,75,141
Oromia,Ilu Aba Bora,Nono Sele,Hamle,11,2009,51,97,98,246
Oromia,Bale,Goba,Teqemt,2,2011,0,55,10,65
Oromia,West Hararge,Gelemso Hospital,Tir,5,2011,52,18,76,146
Oromia,East Shewa,Lomme,Nehase,12,2010,87,39,59,185
Oromia,Ilu Aba Bora,Algesachi,Miyazia,8,2011,63,0,37,100
Oromia,Finfine Zuria,Walmera,Sene,10,2009,70,34,48,152
Oromia,West Shewa,Ejerie,Meskerem,1,2011,25,16,74,115
Oromia,West Arsi,Kofele,Meskerem,1,2011,54,33,38,125
Oromia,East Hararge,Haromaya Hospital,Yekatit,6,2010,23,64,99,186
Oromia,East Shewa,Batu,Hedar,3,2011,15,2,44,61
Oromia,Bale,Dawe Serar,Ginbot,9,2009,34,33,4,71
Oromia,Arsi,Guna,Meskerem,1,2010,68,4,72,144
Oromia,Horo Gudru Wellega,Horro Buluk,Sene,10,2011,39,76,63,178
Oromia,North Shewa,Yaya Gulele,Ginbot,9,2011,48,13,93,154
Oromia,Ilu Aba Bora,Nono Sele,Hedar,3,2010,84,76,42,202
Oromia,East Hararge,Kurfa Chele,Ginbot,9,2010,14,81,95,190
Oromia,East Shewa,Mojo,Megabit,7,2009,39,91,54,184
Oromia,West Arsi,Shala,Tir,5,2009,12,25,37,74
Oromia,Jimma,Limu Kosa,Hamle,11,2009,73,57,4,134
Oromia,West Shewa,Gindeberet Hospital,Ginbot,9,2010,6,16,70,92
Oromia,North Shewa,Kimbibit,Ginbot,9,2009,44,18,14,76
Oromia,Qeleme Wellega,Dambi Dolo Hospital,Tir,5,2011,65,27,93,185
Oromia,Arsi,Munesa,Hedar,3,2010,94,39,10,143
Oromia,East Hararge,Bedeno,Sene,10,2010,24,60,8,92
Oromia,Jimma,Dedo,Nehase,12,2010,66,66,65,197
Oromia,Finfine Zuria,Sandefa,Tir,5,2011,45,36,2,83
Oromia,West Hararge,Doba,Sene,10,2010,90,60,67,217
Oromia,East Shewa,Adama,Megabit,7,2010,72,33,76,181
Oromia,West Guji,Bule Hora Hospital,Megabit,7,2011,55,97,31,183
Oromia,South West Shewa,Goro,Meskerem,1,2011,48,71,38,157
Oromia,Guji,Anna Sora,Sene,10,2010,10,44,5,59
Oromia,West Guji,Kercha Hospital,Tahesas,4,2011,30,76,11,117
Oromia,West Hararge,Gemechis,Meskerem,1,2010,77,54,3,134
Oromia,Qeleme Wellega,Jimma Horo,Nehase,12,2009,39,73,99,211
Oromia,West Hararge,Meiso,Hedar,3,2010,56,36,2,94
Oromia,Arsi,Guna,Nehase,12,2010,20,27,96,143
Oromia,Bale,Goba Town,Meskerem,1,2010,83,74,15,172
Oromia,West Guji,Suro Barguda,Tir,5,2010,83,58,31,172
Oromia,West Arsi,Gedeb Asasa,Tahesas,4,2010,33,38,36,107
Oromia,East Shewa,Olanciti Hospital,Yekatit,6,2009,65,51,6,122
Oromia,Horo Gudru Wellega,Horro Buluk,Hedar,3,2011,15,17,47,79
Oromia,West Shewa,Nono,Ginbot,9,2009,92,21,80,193
Oromia,West Arsi,Shashemene Rural,Yekatit,6,2011,44,21,35,100
Oromia,North Shewa,Jido,Hamle,11,2010,38,94,17,149
Oromia,Robe Town,Robe Town,Hedar,3,2010,47,4,51,102
Oromia,Borena,Moyale Hospital,Meskerem,1,2010,15,89,79,183
Oromia,West Arsi,Hebal Arsi,Hedar,3,2011,72,2,20,94
Oromia,Ilu Aba Bora,Algesachi,Meskerem,1,2010,70,72,45,187
Oromia,Buno Bedele,Bedele Town,Megabit,7,2009,28,15,37,80
Oromia,West Hararge,Meiso,Yekatit,6,2010,28,97,20,145
Oromia,Buno Bedele,Bedele Town,Sene,10,2010,40,88,15,143
Oromia,Arsi,Gololcha,Ginbot,9,2009,87,12,42,141
Oromia,West Guji,Kercha,Meskerem,1,2010,59,60,18,137
Oromia,North Shewa,Jido,Nehase,12,2010,68,72,77,217
Oromia,Bale,Goba,Meskerem,1,2011,24,65,63,152
Oromia,West Guji,Bule Hora Toun,Megabit,7,2009,88,81,55,224
Oromia,North Shewa,Kuyu Hospital,Teqemt,2,2010,17,10,87,114
Oromia,East Hararge,Aweday Town,Miyazia,8,2011,14,11,83,108
Oromia,East Shewa,Fentale,Hedar,3,2011,34,79,69,182
Oromia,Horo Gudru Wellega,Jima Rare,Miyazia,8,2010,6,12,56,74
Oromia,West Guji,Suro Barguda,Miyazia,8,2011,5,23,67,95
Oromia,South West Shewa,Becho,Ginbot,9,2010,16,22,68,106
Oromia,West Wellega,Lata Sibu,Nehase,12,2009,70,69,1,140
Oromia,East Hararge,Garemuleta Hospital,Ginbot,9,2010,24,52,21,97
Oromia,North Shewa,Dera Hospital,Ginbot,9,2009,97,6,77,180
Oromia,West Wellega,Mendi Town,Miyazia,8,2010,27,65,73,165
Oromia,West Guji,Dugda Dawa,Ginbot,9,2010,58,77,77,212
Oromia,Qeleme Wellega,Seyo,Sene,10,2009,57,86,96,239
Oromia,West Hararge,Tulo,Nehase,12,2009,80,14,50,144
Oromia,West Guji,Dugda Dawa,Megabit,7,2009,68,14,97,179
Oromia,Arsi,Limuna Bilbilo,Meskerem,1,2010,48,62,4,114
Oromia,East Hararge,Jarso,Tahesas,4,2010,89,65,42,196
Oromia,North Shewa,Dera,Sene,10,2011,74,40,27,141
Oromia,Bale,Goba,Yekatit,6,2009,43,67,60,170
Oromia,East Shewa,Lomme,Ginbot,9,2010,79,28,84,191
Oromia,Horo Gudru Wellega,Jima Rare,Nehase,12,2010,79,99,27,205
Oromia,Horo Gudru Wellega,Jima Rare,Yekatit,6,2009,89,74,21,184
Oromia,East Wellega,Gobu Seyo,Meskerem,1,2010,6,62,57,125
Oromia,West Hararge,Chiro Zuriya,Nehase,12,2010,77,56,9,142
Oromia,West Wellega,Ayira,Megabit,7,2009,92,71,77,240
Oromia,North Shewa,Degem,Meskerem,1,2011,12,36,37,85
Oromia,Borena,Arero,Hamle,11,2009,50,27,29,106
Oromia,West Wellega,Gimbi Public  Hospital,Nehase,12,2009,68,44,7,119
Oromia,North Shewa,Fiche Hospital,Megabit,7,2009,96,69,21,186
Oromia,Jimma,Sigmo,Yekatit,6,2009,86,45,65,196
Oromia,West Arsi,Gambo Hospital,Miyazia,8,2010,28,69,41,138
Oromia,West Guji,Abaya,Hamle,11,2009,15,48,57,120
Oromia,Borena,Dilo,Hamle,11,2009,54,78,70,202
Oromia,East Hararge,Kombolicha,Hedar,3,2011,71,33,68,172
Oromia,Jimma,Mana,Meskerem,1,2010,73,29,54,156
Oromia,West Wellega,Jarso,Miyazia,8,2009,83,15,24,122
Oromia,Bale,Ginir Town,Yekatit,6,2011,26,58,42,126
Oromia,Guji,Adola Reda,Tahesas,4,2011,23,7,71,101
Oromia,Buno Bedele,Chora,Sene,10,2011,92,15,24,131
Oromia,Bale,Legehida,Sene,10,2009,1,34,19,54
Oromia,East Hararge,Gole Oda,Tahesas,4,2010,99,4,61,164
Oromia,Jimma,Seka Chekorsa,Megabit,7,2010,93,18,44,155
Oromia,Jimma,Limu Hospital,Hedar,3,2011,96,30,95,221
Oromia,West Wellega,Nejo Rural,Yekatit,6,2009,93,60,50,203
Oromia,East Shewa,Adami Tulu Jido Kombolcha,Teqemt,2,2010,41,86,39,166
Oromia,Qeleme Wellega,Gawo Qebe,Miyazia,8,2009,75,67,26,168
Oromia,Arsi,Chole,Teqemt,2,2011,80,92,84,256
Oromia,West Wellega,Gimbi Rural,Meskerem,1,2010,39,87,52,178
Oromia,West Arsi,Shashemene Rural,Miyazia,8,2011,95,73,61,229
Oromia,West Shewa,Guder Hosp,Megabit,7,2011,12,78,31,121
Oromia,Bale,Meda Welabu,Tahesas,4,2011,72,16,68,156
Oromia,Jimma,Agaro,Hamle,11,2010,96,25,92,213
Oromia,Jimma,Seka Chekorsa,Hamle,11,2010,39,97,71,207
Oromia,Borena,Moyale,Ginbot,9,2011,30,71,28,129
Oromia,Guji,Uraga,Nehase,12,2010,4,58,29,91
Oromia,Borena,El Way,Sene,10,2010,53,42,84,179
Oromia,Arsi,Sude,Hedar,3,2011,88,36,18,142
Oromia,West Hararge,West Harerge	Gumbi Bordede,Megabit,7,2009,13,74,10,97
Oromia,North Shewa,Aleiltu,Hamle,11,2009,8,50,31,89
Oromia,West Shewa,Tibe Kutaye,Nehase,12,2009,86,26,93,205
Oromia,Jimma,Sekoru,Ginbot,9,2011,27,96,92,215
Oromia,Jimma,Gera,Tir,5,2009,0,51,81,132
Oromia,East Hararge,Deder,Yekatit,6,2010,81,21,14,116
Oromia,East Hararge,Deder Hospital,Sene,10,2011,33,30,61,124
Oromia,West Hararge,Chiro Hospital,Yekatit,6,2009,8,70,41,119
Oromia,East Hararge,Girawa,Tir,5,2009,25,18,69,112
Oromia,Horo Gudru Wellega,Horo,Miyazia,8,2010,68,34,76,178
Oromia,South West Shewa,Seden Sodo,Miyazia,8,2009,81,66,74,221
Oromia,Arsi,Tiyo,Tir,5,2010,15,30,93,138
Oromia,East Wellega,Gobu Seyo,Teqemt,2,2010,63,49,69,181
Oromia,Guji,Saba Boru,Tir,5,2010,4,33,95,132
Oromia,East Hararge,Garemuleta Hospital,Meskerem,1,2011,54,95,57,206
Oromia,Adama Special Town,Adama Town,Ginbot,9,2009,37,52,80,169
Oromia,Jimma,Setema,Miyazia,8,2011,80,75,66,221
Oromia,West Hararge,Boke,Megabit,7,2009,10,57,22,89
Oromia,West Shewa,Elifata,Miyazia,8,2010,50,63,6,119
Oromia,West Wellega,Nole Kaba,Hedar,3,2010,1,24,8,33
Oromia,Guji,Wadara,Hamle,11,2009,0,81,35,116
Oromia,Jimma,Mancho,Megabit,7,2009,76,23,66,165
Oromia,West Shewa,Guder Hosp,Tir,5,2011,54,11,11,76
Oromia,West Wellega,Nole Kaba,Tir,5,2010,36,7,67,110
Oromia,West Wellega,Qiltu Kara,Teqemt,2,2010,60,76,25,161
Oromia,East Shewa,Adea,Ginbot,9,2010,8,31,10,49
Oromia,East Hararge,Kersa Eh,Sene,10,2011,38,10,91,139
Oromia,West Hararge,Gelemso Hospital,Ginbot,9,2009,96,12,77,185
Oromia,East Shewa,Liben,Tir,5,2010,56,77,76,209
Oromia,West Guji,Bule Hora Toun,Tahesas,4,2010,10,2,13,25
Oromia,Horo Gudru Wellega,Jima Rare,Nehase,12,2009,10,11,0,21
Oromia,North Shewa,Aleiltu,Miyazia,8,2010,84,59,13,156
Oromia,East Hararge,Babile,Hamle,11,2009,11,75,96,182
Oromia,Horo Gudru Wellega,Shambu Hospital,Nehase,12,2010,79,81,21,181
Oromia,East Hararge,Bedeno,Hamle,11,2009,30,40,84,154
Oromia,East Hararge,Goro Muti,Tir,5,2011,52,9,51,112
Oromia,Guji,Saba Boru,Hamle,11,2010,31,35,67,133
Oromia,East Hararge,Deder Hospital,Miyazia,8,2011,57,54,25,136
Oromia,West Shewa,Guder Hosp,Hamle,11,2010,64,75,63,202
Oromia,West Wellega,Mendi Town,Teqemt,2,2011,48,1,86,135
Oromia,Buno Bedele,Dapho Hana,Miyazia,8,2011,15,24,95,134
Oromia,East Wellega,Ebantu,Tir,5,2009,92,21,75,188
Oromia,Horo Gudru Wellega,Shambu Hospital,Miyazia,8,2011,5,24,85,114
Oromia,South West Shewa,Goro,Sene,10,2010,11,39,75,125
Oromia,East Wellega,Wayu Tuqa,Yekatit,6,2010,10,30,72,112
Oromia,Arsi,Ludehetosa,Ginbot,9,2010,27,86,23,136
Oromia,Arsi,Shenan Kolu,Nehase,12,2009,92,70,37,199
Oromia,Borena,Dubluk,Hamle,11,2009,38,31,24,93
Oromia,West Guji,Hanbala,Teqemt,2,2011,85,26,93,204
Oromia,Burayu Town,Burayu Town,Megabit,7,2009,46,32,52,130
Oromia,East Shewa,Adea,Tahesas,4,2011,41,83,89,213
Oromia,East Hararge,Kersa Eh,Miyazia,8,2009,51,88,80,219
Oromia,Bale,Legehida,Sene,10,2009,44,62,47,153
Oromia,Jimma,Shabe,Ginbot,9,2009,3,6,76,85
Oromia,Jimma,Omonada,Meskerem,1,2011,94,60,14,168
Oromia,Jimma,Omo Nada Hospital,Tahesas,4,2011,58,80,97,235
Oromia,West Hararge,Doba,Megabit,7,2010,71,24,81,176
Oromia,West Wellega,Guliso,Yekatit,6,2009,96,37,62,195
Oromia,Horo Gudru Wellega,Abe Dengoro,Megabit,7,2011,98,23,26,147
Oromia,East Hararge,Goro Gutu,Nehase,12,2009,30,94,29,153
Oromia,East Wellega,Gida Ayana,Teqemt,2,2011,24,41,13,78
Oromia,Guji,Gumi Eldallo,Miyazia,8,2009,51,75,72,198
Oromia,East Hararge,Babile Woreda,Teqemt,2,2010,89,42,32,163
Oromia,Horo Gudru Wellega,Jarte Jardga,Miyazia,8,2010,19,99,61,179
Oromia,Guji,Adola Town,Tir,5,2010,36,16,40,92
Oromia,Guji,Dima,Tahesas,4,2011,83,11,52,146
Oromia,North Shewa,Hidabu Abote,Tir,5,2010,16,92,0,108
Oromia,Jimma,Gera,Tir,5,2011,92,38,71,201
Oromia,Jimma,Sekoru,Meskerem,1,2010,16,49,57,122
Oromia,Bishoftu Town,Bishoftu Town,Ginbot,9,2011,33,89,81,203
Oromia,East Hararge,Kumbi,Yekatit,6,2011,65,6,58,129
Oromia,East Hararge,Kurfa Chele,Ginbot,9,2011,73,85,74,232
Oromia,West Guji,Bule Hora,Miyazia,8,2010,14,15,34,63
Oromia,Finfine Zuria,Sandefa,Tir,5,2011,55,75,90,220
Oromia,Jimma,Seka Chekorsa,Hedar,3,2010,0,32,94,126
Oromia,East Wellega,Guto Gida,Teqemt,2,2010,53,82,70,205
Oromia,West Wellega,Homa,Hedar,3,2011,75,27,96,198
Oromia,East Wellega,Nunu Qumba,Hamle,11,2010,49,67,1,117
Oromia,Holeta Town,Holeta Town,Teqemt,2,2011,93,5,82,180
Oromia,South West Shewa,Bantu  Hospital,Ginbot,9,2011,51,21,39,111
Oromia,West Wellega,Ayira,Miyazia,8,2010,47,1,81,129
Oromia,West Hararge,Tulo,Megabit,7,2009,36,20,21,77
Oromia,East Hararge,Chinakesen,Sene,10,2010,45,62,91,198
Oromia,West Wellega,Homa,Yekatit,6,2010,32,89,48,169
Oromia,Arsi,Sire,Nehase,12,2009,76,64,52,192
Oromia,North Shewa,Dera,Megabit,7,2011,7,94,55,156
Oromia,West Guji,Hanbala,Meskerem,1,2011,73,5,37,115
Oromia,West Wellega,Boji Cheqorsa,Tahesas,4,2010,59,33,66,158
Oromia,Shashamane Town,Shashamane Town,Tahesas,4,2010,95,85,93,273
Oromia,East Wellega,Wayu Tuqa,Hamle,11,2010,69,97,57,223
Oromia,West Shewa,Ilu Galan,Yekatit,6,2009,35,63,69,167
Oromia,Arsi,Jeju,Nehase,12,2010,29,3,86,118
Oromia,West Wellega,Boji Cheqorsa,Hamle,11,2010,42,6,71,119
Oromia,Finfine Zuria,Berreh,Yekatit,6,2011,53,48,94,195
Oromia,West Shewa,Codi,Tahesas,4,2011,83,95,75,253
Oromia,Horo Gudru Wellega,Horo,Ginbot,9,2011,23,71,39,133
Oromia,Jimma,Agaro,Miyazia,8,2010,16,95,65,176
Oromia,East Shewa,Adami Tulu Jido Kombolcha,Hedar,3,2011,5,9,79,93
Oromia,Horo Gudru Wellega,Amuru,Miyazia,8,2010,31,86,10,127
Oromia,West Guji,Mkelka Soda,Yekatit,6,2009,73,90,14,177
Oromia,West Guji,Hanbala,Hamle,11,2009,91,26,91,208
Oromia,Guji,Odo Shakiso,Yekatit,6,2009,54,74,79,207
Oromia,West Shewa,Elifata,Nehase,12,2009,56,61,17,134
Oromia,Buno Bedele,Gechi,Ginbot,9,2009,22,50,26,98
Oromia,West Wellega,Babo Gembel,Nehase,12,2009,99,13,70,182
Oromia,West Wellega,Jarso,Megabit,7,2010,83,25,77,185
Oromia,East Wellega,Diga,Tahesas,4,2011,7,24,39,70
Oromia,West Arsi,Shashemene Rural,Yekatit,6,2010,65,46,12,123
Oromia,West Arsi,Dodola Town,Miyazia,8,2009,85,2,49,136
Oromia,Bale,Seweyna,Tir,5,2011,49,79,78,206
Oromia,Adama Special Town,Adama Town,Ginbot,9,2009,93,26,18,137
Oromia,Jimma,Seka Chhokorsa Hospital,Hamle,11,2010,98,8,76,182
Oromia,Bale,Legehida,Ginbot,9,2010,70,77,69,216
Oromia,Ilu Aba Bora,Ale,Miyazia,8,2011,28,12,81,121
Oromia,West Wellega,Qiltu Kara,Miyazia,8,2011,39,30,34,103
Oromia,West Shewa,Ambo Hospital,Hedar,3,2011,67,89,36,192
Oromia,North Shewa,Kimbibit,Sene,10,2009,5,73,48,126
Oromia,Finfine Zuria,Berreh,Megabit,7,2010,32,22,47,101
Oromia,Gelan Town,Gelan Town,Ginbot,9,2009,46,24,8,78
Oromia,Ilu Aba Bora,Darimu,Megabit,7,2011,0,62,33,95
Oromia,Qeleme Wellega,Yemalogi Wolel,Yekatit,6,2010,26,22,75,123
Oromia,East Hararge,Haromaya Rural,Yekatit,6,2009,51,41,2,94
Oromia,Finfine Zuria,Sandefa,Miyazia,8,2011,94,40,94,228
Oromia,Qeleme Wellega,Anfilo,Nehase,12,2009,58,29,82,169
Oromia,West Shewa,Ambo University  Hosp,Nehase,12,2010,74,40,23,137
Oromia,South West Shewa,Sodo Dac'Ha,Meskerem,1,2010,59,3,91,153
Oromia,East Hararge,Deder Town,Ginbot,9,2011,24,94,93,211
Oromia,West Shewa,Jibat,Teqemt,2,2011,58,29,56,143
Oromia,Borena,Yabelo Rural,Megabit,7,2009,18,80,43,141
Oromia,East Shewa,Fentale,Miyazia,8,2009,34,5,27,66
Oromia,Adama Special Town,Adama Town,Hamle,11,2010,13,50,37,100
Oromia,Guji,Anna Sora,Tir,5,2010,88,72,20,180
Oromia,West Arsi,Siraro,Meskerem,1,2011,39,1,90,130
Oromia,Qeleme Wellega,Yemalogi Wolel,Ginbot,9,2011,98,98,56,252
Oromia,East Wellega,Kiremu,Nehase,12,2009,29,11,56,96
Oromia,West Guji,Mkelka Soda,Tir,5,2009,88,78,84,250
Oromia,West Arsi,Nensebo,Miyazia,8,2009,65,61,48,174
Oromia,East Hararge,Fedis,Tahesas,4,2010,41,54,39,134
Oromia,Bale,Delo Mena,Nehase,12,2009,36,63,30,129
Oromia,North Shewa,Dera,Tahesas,4,2010,1,40,2,43
Oromia,Jimma,Gomma,Tahesas,4,2011,66,2,18,86
Oromia,Bale,Robe Town,Megabit,7,2009,56,37,29,122
Oromia,Adama Special Town,Adama Town,Megabit,7,2010,8,24,5,37
Oromia,Bale,Meda Welabu,Hedar,3,2011,90,72,23,185
Oromia,Borena,Yabelo Rural,Teqemt,2,2010,15,72,30,117
Oromia,South West Shewa,Woliso Rural,Tir,5,2011,48,49,93,190
Oromia,Qeleme Wellega,Dambi Dolo Hospital,Miyazia,8,2011,40,49,59,148
Oromia,Ilu Aba Bora,Algesachi,Sene,10,2010,92,41,55,188
Oromia,South West Shewa,Tulu Bolo Hospital,Hamle,11,2010,12,9,79,100
Oromia,West Hararge,Mesela,Yekatit,6,2010,95,67,97,259
Oromia,Borena,Dilo,Ginbot,9,2009,76,52,38,166
Oromia,Arsi,Hitosa,Megabit,7,2011,91,53,4,148
Oromia,West Guji,Bule Hora Hospital,Hamle,11,2010,3,15,59,77
Oromia,West Shewa,Inchini Hospital,Tir,5,2010,34,70,53,157
Oromia,Sululta Town,Sululta Town,Yekatit,6,2009,64,76,11,151
Oromia,South West Shewa,Tole,Hamle,11,2009,49,81,15,145
Oromia,West Shewa,Ambo,Nehase,12,2009,94,22,79,195
Oromia,Qeleme Wellega,Dambi Dollo,Yekatit,6,2011,36,86,47,169
Oromia,East Wellega,Limu,Sene,10,2011,79,94,93,266
Oromia,West Arsi,Kofele,Teqemt,2,2011,67,56,39,162
Oromia,West Wellega,Seyo Nole,Miyazia,8,2010,61,54,45,160
Oromia,Borena,Moyale Hospital,Hedar,3,2010,33,80,28,141
Oromia,Qeleme Wellega,Dambi Dollo,Ginbot,9,2010,91,68,68,227
Oromia,East Wellega,Kiremu,Ginbot,9,2011,73,93,26,192
Oromia,West Wellega,Haru,Megabit,7,2011,53,85,6,144
Oromia,Jimma,Sigmo,Yekatit,6,2010,21,60,95,176
Oromia,West Arsi,Kokosa,Yekatit,6,2009,95,83,90,268
Oromia,Bale,Goba,Sene,10,2009,9,31,76,116
Oromia,West Guji,Bule Hora Hospital,Sene,10,2009,74,59,48,181
Oromia,Finfine Zuria,Berreh,Hedar,3,2010,77,46,81,204
Oromia,West Shewa,Codi,Yekatit,6,2011,72,94,59,225
Oromia,Guji,Anna Sora,Miyazia,8,2010,44,52,25,121
Oromia,Guji,Girja,Ginbot,9,2010,78,96,76,250
Oromia,West Wellega,Kundala,Nehase,12,2010,44,44,51,139
Oromia,West Arsi,Dodola Rural,Tahesas,4,2010,55,1,93,149
Oromia,West Guji,Bule Hora Hospital,Hedar,3,2011,42,76,84,202
Oromia,Borena,Moyale,Hedar,3,2010,64,91,71,226
Oromia,North Shewa,Aleiltu,Ginbot,9,2010,9,74,81,164
Oromia,South West Shewa,Ilu,Miyazia,8,2010,42,71,57,170
Oromia,Guji,Adola Town,Sene,10,2010,97,80,93,270
Oromia,Ilu Aba Bora,Metu Rural,Megabit,7,2010,93,31,82,206
Oromia,Bale,Dawe Serar,Sene,10,2009,5,53,93,151
Oromia,Jimma,B/Tolyi,Tir,5,2011,9,5,18,32
Oromia,West Wellega,Haru,Yekatit,6,2010,87,18,69,174
Oromia,Borena,Yabelo Rural,Megabit,7,2009,72,27,17,116
Oromia,South West Shewa,Tole,Tir,5,2010,45,75,8,128
Oromia,Horo Gudru Wellega,Shambu Hospital,Ginbot,9,2011,60,44,49,153
Oromia,Bale,Ginir Town,Sene,10,2009,56,56,45,157
Oromia,Bale,Goro,Miyazia,8,2011,14,30,38,82
Oromia,Arsi,Shirka,Megabit,7,2011,1,16,8,25
Oromia,Ilu Aba Bora,Ale,Tir,5,2009,86,5,16,107
Oromia,East Wellega,Wayu Tuqa,Ginbot,9,2010,83,21,60,164
Oromia,Buno Bedele,Boricha,Teqemt,2,2010,90,46,28,164
Oromia,North Shewa,Aleiltu,Megabit,7,2010,17,46,92,155
Oromia,Qeleme Wellega,Gidami,Nehase,12,2010,55,14,86,155
Oromia,East Hararge,Kombolicha,Tir,5,2011,93,38,96,227
Oromia,Guji,Odo Shakiso,Ginbot,9,2010,28,0,43,71
Oromia,North Shewa,Kuyu,Hedar,3,2010,95,89,99,283
Oromia,East Hararge,Chinakesen,Yekatit,6,2010,16,89,27,132
Oromia,Arsi,Jeju,Hedar,3,2010,92,77,18,187
Oromia,East Shewa,Adami Tulu Jido Kombolcha,Hamle,11,2009,36,9,38,83
Oromia,Jimma,Dedo,Hamle,11,2010,99,9,19,127
Oromia,Buno Bedele,Dedesa,Miyazia,8,2011,67,72,25,164
Oromia,Borena,Wachile,Yekatit,6,2011,31,26,46,103
Oromia,West Arsi,Nensebo,Miyazia,8,2009,84,82,81,247
Oromia,South West Shewa,Becho,Ginbot,9,2011,28,98,15,141
Oromia,Borena,Dire,Ginbot,9,2009,28,69,23,120
Oromia,West Wellega,Ayira Hospital,Hedar,3,2010,35,40,74,149
Oromia,North Shewa,Hidabu Abote,Meskerem,1,2010,39,81,9,129
Oromia,Guji,Adola Town,Nehase,12,2010,32,92,80,204
Oromia,Bale,Seweyna,Hamle,11,2010,58,60,55,173
Oromia,Arsi,Tiyo,Ginbot,9,2011,10,1,39,50
Oromia,Guji,Girja,Hedar,3,2011,94,53,15,162
Oromia,East Hararge,Chelenko Hospital,Ginbot,9,2009,92,20,9,121
Oromia,West Shewa,Metarobi,Tahesas,4,2010,54,73,79,206
Oromia,Bale,Sinana,Ginbot,9,2010,13,12,43,68
Oromia,Bale,Ginir,Yekatit,6,2010,5,15,90,110
Oromia,Arsi,Tiyo,Sene,10,2009,81,26,87,194
Oromia,West Hararge,Mesela,Hedar,3,2010,25,60,11,96
Oromia,Horo Gudru Wellega,Jima Geneti,Tir,5,2010,29,93,92,214
Oromia,West Wellega,Gimbi Adventist Hospital,Nehase,12,2010,72,34,5,111
Oromia,Arsi,Amigna,Hamle,11,2009,55,39,6,100
Oromia,West Wellega,Mendi Town,Ginbot,9,2010,44,31,98,173
Oromia,West Hararge,Burka Dimtu,Megabit,7,2010,19,85,33,137
Oromia,West Arsi,Arsi Negele Rural,Sene,10,2009,79,69,46,194
Oromia,Jimma,O/Beyam,Sene,10,2011,41,95,3,139
Oromia,West Arsi,Dodola Town,Nehase,12,2010,60,19,36,115
Oromia,Arsi,Tiyo,Teqemt,2,2011,94,36,46,176
Oromia,East Wellega,Leqa Dulecha,Tahesas,4,2010,9,19,20,48
Oromia,East Hararge,Chinakesen,Tahesas,4,2011,53,23,44,120
Oromia,North Shewa,Jido,Miyazia,8,2011,62,60,50,172
Oromia,East Hararge,Deder,Meskerem,1,2011,34,94,24,152
Oromia,West Hararge,Chiro Hospital,Sene,10,2010,9,12,15,36
Oromia,Ilu Aba Bora,Yayu,Sene,10,2010,68,52,37,157
Oromia,East Wellega,Wama Hagelo,Yekatit,6,2009,68,64,42,174
Oromia,East Shewa,Matahara,Hamle,11,2009,30,37,78,145
Oromia,West Hararge,Burka Dimtu,Ginbot,9,2011,25,5,30,60
Oromia,West Wellega,Gimbi,Nehase,12,2009,61,93,83,237
Oromia,Shashamane Town,Shashamane Town,Yekatit,6,2009,67,82,14,163
Oromia,West Hararge,Meiso,Meskerem,1,2010,4,26,21,51
Oromia,South West Shewa,Tulu Bolo Hospital,Hedar,3,2010,35,80,93,208
Oromia,East Hararge,Girawa,Teqemt,2,2010,75,8,3,86
Oromia,Borena,Guchi,Hamle,11,2009,53,63,91,207
Oromia,East Hararge,Kombolicha,Megabit,7,2011,55,68,35,158
Oromia,Horo Gudru Wellega,Abe Dengoro,Miyazia,8,2011,97,64,82,243
Oromia,East Shewa,Fentale,Megabit,7,2010,54,61,8,123
Oromia,Buno Bedele,Chewaqa,Miyazia,8,2011,35,54,25,114
Oromia,West Wellega,Ayira Hospital,Sene,10,2011,56,13,85,154
Oromia,Finfine Zuria,Sululta Town,Megabit,7,2010,89,62,80,231
Oromia,West Shewa,Jibat,Miyazia,8,2011,80,27,20,127
Oromia,West Shewa,Abuna Gindeberet,Teqemt,2,2010,5,8,3,16
Oromia,East Shewa,Olanciti Hospital,Yekatit,6,2010,82,27,99,208
Oromia,Guji,Adola Hospital,Ginbot,9,2010,23,27,18,68
Oromia,West Hararge,Chiro Town,Miyazia,8,2010,86,27,10,123
Oromia,West Wellega,Lalo Asabi,Sene,10,2011,86,81,66,233
Oromia,Arsi,Gololcha,Nehase,12,2009,20,89,21,130
Oromia,East Wellega,Nunu Qumba,Ginbot,9,2009,79,21,16,116
Oromia,Arsi,Tiyo,Hedar,3,2010,21,38,67,126
Oromia,Arsi,Enkelo Wabe,Meskerem,1,2011,54,74,31,159
Oromia,Shashamane Town,Shashamane Town,Hedar,3,2011,10,84,46,140
Oromia,South West Shewa,Ameya,Miyazia,8,2011,97,10,67,174
Oromia,North Shewa,Abichugna,Megabit,7,2010,18,22,63,103
Oromia,East Wellega,Guto Gida,Tir,5,2010,4,58,84,146
Oromia,Buno Bedele,Chora,Sene,10,2010,17,35,35,87
Oromia,West Shewa,Inchini Hospital,Ginbot,9,2009,90,34,74,198
Oromia,West Wellega,Nejo Rural,Ginbot,9,2010,44,22,33,99
Oromia,Jimma,Seka Chekorsa,Megabit,7,2010,6,16,82,104
Oromia,Borena,Dubluk,Tir,5,2010,38,30,91,159
Oromia,Borena,Dire,Sene,10,2009,28,40,34,102
Oromia,West Guji,Bule Hora Toun,Ginbot,9,2011,61,74,44,179
Oromia,East Wellega,Wayu Tuqa,Tir,5,2011,60,63,83,206
Oromia,West Shewa,Ambo Hospital,Nehase,12,2010,47,58,91,196
Oromia,East Wellega,Wama Hagelo,Miyazia,8,2011,95,86,27,208
Oromia,Ilu Aba Bora,Becho,Ginbot,9,2010,82,10,43,135
Oromia,Borena,Yabelo Hospital,Megabit,7,2009,35,1,55,91
Oromia,Guji,Adola Reda,Hamle,11,2009,70,71,15,156
Oromia,East Hararge,Midega Tole,Yekatit,6,2009,16,54,62,132
Oromia,East Shewa,Adama,Yekatit,6,2010,66,42,65,173
Oromia,Ilu Aba Bora,Ale,Tir,5,2011,12,94,48,154
Oromia,East Hararge,Garemuleta Hospital,Hamle,11,2009,68,50,40,158
Oromia,West Wellega,Haru,Teqemt,2,2010,45,17,88,150
Oromia,East Hararge,Bisidimo Hospital,Meskerem,1,2010,94,34,5,133
Oromia,West Wellega,Guliso,Miyazia,8,2010,31,78,78,187
Oromia,East Hararge,Deder Hospital,Tahesas,4,2011,77,82,29,188
Oromia,Arsi,Robe,Ginbot,9,2010,16,9,22,47
Oromia,Guji,Adola Reda,Tir,5,2011,58,6,86,150
Oromia,Jimma,Agaro,Sene,10,2009,27,13,65,105
Oromia,West Hararge,Oda Bultum,Meskerem,1,2010,29,75,20,124
Oromia,West Wellega,Yubdo,Megabit,7,2010,1,8,44,53
Oromia,Arsi,Shirka,Ginbot,9,2010,33,46,63,142
Oromia,Borena,Gomole,Ginbot,9,2009,93,10,88,191
Oromia,Horo Gudru Wellega,Jima Geneti,Sene,10,2009,27,75,79,181
Oromia,West Hararge,Habro,Megabit,7,2010,77,63,74,214
Oromia,West Wellega,Mene Sibu,Miyazia,8,2011,17,7,25,49
Oromia,Buno Bedele,Boricha,Tir,5,2011,38,53,15,106
Oromia,Arsi,Merti,Tir,5,2011,32,42,3,77
Oromia,Arsi,Tiyo,Megabit,7,2010,97,48,65,210
Oromia,East Wellega,Nunu Qumba,Meskerem,1,2011,22,46,42,110
Oromia,West Wellega,Begi,Yekatit,6,2010,27,73,81,181
Oromia,Finfine Zuria,Berreh,Ginbot,9,2010,15,71,2,88
Oromia,Borena,Yabelo Hospital,Miyazia,8,2009,90,22,49,161
Oromia,Buno Bedele,Meko,Hamle,11,2009,73,63,27,163
Oromia,East Wellega,Guto Gida,Sene,10,2010,6,83,27,116
Oromia,South West Shewa,Ameya,Sene,10,2010,43,40,48,131
Oromia,Horo Gudru Wellega,Shambu Town,Megabit,7,2010,26,12,52,90
Oromia,Buno Bedele,Dapho Hana,Ginbot,9,2011,54,96,18,168
Oromia,West Wellega,Begi Hospital,Miyazia,8,2010,89,45,18,152
Oromia,East Wellega,Gudeyabila,Hedar,3,2010,9,60,23,92
Oromia,Lege Dadi Lege Tafo Town,Lege Dadi Lege Tafo Town,Ginbot,9,2010,92,23,47,162
Oromia,Arsi,Jeju,Hedar,3,2011,77,2,24,103
Oromia,East Wellega,Ebantu,Miyazia,8,2010,28,46,60,134
Oromia,West Wellega,Haru,Tahesas,4,2010,58,91,54,203
Oromia,East Hararge,Kombolicha,Meskerem,1,2010,80,52,39,171
Oromia,West Hararge,Daro Lebu,Miyazia,8,2010,21,17,70,108
Oromia,Guji,Adola Reda,Yekatit,6,2009,44,67,11,122
Oromia,Bale,Ginir,Megabit,7,2010,95,91,94,280
Oromia,East Hararge,Meyu Muleke,Hamle,11,2009,89,11,29,129
Oromia,Arsi,Robe,Nehase,12,2009,42,5,31,78
Oromia,Jimma,Tiro Afeta,Hedar,3,2011,40,20,90,150
Oromia,West Shewa,Dendi,Hedar,3,2010,21,48,33,102
Oromia,Ilu Aba Bora,Darimu,Nehase,12,2009,76,83,47,206
Oromia,Guji,Hambela Wamena,Nehase,12,2010,60,93,11,164
Oromia,Jimma,O/Beyam,Miyazia,8,2011,66,61,63,190
Oromia,Arsi,Chole,Miyazia,8,2010,32,92,85,209
Oromia,Arsi,Shirka,Tir,5,2010,93,15,50,158
Oromia,West Guji,Bule Hora,Megabit,7,2010,81,2,57,140
Oromia,Jimma,Mana,Ginbot,9,2011,44,86,96,226
Oromia,Guji,Negele Hospital,Megabit,7,2011,45,33,81,159
Oromia,East Wellega,Boneya Bushe,Teqemt,2,2011,9,76,88,173
Oromia,Arsi,Zeway Dugda,Ginbot,9,2009,49,89,62,200
Oromia,Woliso Town,Woliso Town,Megabit,7,2011,90,35,8,133
Oromia,South West Shewa,Kersana Malima,Ginbot,9,2009,19,20,87,126
Oromia,Arsi,Hitosa,Miyazia,8,2010,73,69,91,233
Oromia,West Guji,Bule Hora Toun,Yekatit,6,2011,70,0,56,126
Oromia,West Shewa,Ejerie,Hedar,3,2010,1,61,73,135
Oromia,West Arsi,Wondo,Hamle,11,2010,53,71,51,175
Oromia,Bale,Arena Buluq,Nehase,12,2010,62,30,66,158
Oromia,Borena,Guchi,Ginbot,9,2011,93,37,51,181
Oromia,North Shewa,Aleiltu,Hedar,3,2011,39,98,79,216
Oromia,Guji,Negele Hospital,Miyazia,8,2009,45,30,50,125
Oromia,West Wellega,Boji Cheqorsa,Hamle,11,2010,10,79,33,122
Oromia,West Wellega,Lata Sibu,Miyazia,8,2009,43,77,47,167
Oromia,Guji,Odo Shakiso,Ginbot,9,2010,84,87,13,184
Oromia,West Shewa,Elifata,Hedar,3,2010,90,43,15,148
Oromia,Jimma,Nono Benja,Hedar,3,2011,57,56,72,185
Oromia,West Wellega,Guliso,Miyazia,8,2011,9,71,48,128
Oromia,East Wellega,Nunu Qumba,Meskerem,1,2010,35,36,73,144
Oromia,Guji,Odo Shakiso,Megabit,7,2009,6,57,14,77
Oromia,Horo Gudru Wellega,Shambu Town,Teqemt,2,2010,77,78,24,179
Oromia,West Hararge,Mesela,Meskerem,1,2010,97,0,47,144
Oromia,East Hararge,Babile Woreda,Nehase,12,2010,87,55,16,158
Oromia,West Wellega,Boji Cheqorsa,Megabit,7,2011,78,76,75,229
Oromia,Lege Dadi Lege Tafo Town,Lege Dadi Lege Tafo Town,Hamle,11,2010,9,49,71,129
Oromia,Arsi,Zeway Dugda,Miyazia,8,2009,68,6,55,129
Oromia,Borena,Arero,Meskerem,1,2011,10,26,93,129
Oromia,North Shewa,Debre Libanos,Yekatit,6,2011,25,68,32,125
Oromia,South West Shewa,Seden Sodo,Yekatit,6,2010,31,58,65,154
Oromia,Bale,Dawe Serar,Hamle,11,2010,45,48,60,153
Oromia,East Hararge,Haromaya Town,Tahesas,4,2011,37,75,36,148
Oromia,West Wellega,Genji,Hamle,11,2010,64,3,69,136
Oromia,Jimma,Mana,Miyazia,8,2010,74,52,75,201
Oromia,Ilu Aba Bora,Yayu,Tir,5,2009,9,17,7,33
Oromia,Guji,Gumi Eldallo,Ginbot,9,2010,32,1,68,101
Oromia,East Hararge,Haromaya Town,Sene,10,2009,55,52,10,117
Oromia,Bale,Gololcha,Nehase,12,2010,52,88,65,205
Oromia,West Shewa,Jibat,Megabit,7,2010,38,48,84,170
Oromia,East Wellega,Ebantu,Hamle,11,2009,43,40,42,125
Oromia,Jimma,Gomma,Miyazia,8,2010,39,40,92,171
Oromia,Jimma,Gomma,Hedar,3,2011,99,20,18,137
Oromia,South West Shewa,Dawo,Meskerem,1,2010,65,32,43,140
Oromia,Bale,Arena Buluq,Miyazia,8,2011,97,70,25,192
Oromia,West Wellega,Gimbi Adventist Hospital,Meskerem,1,2011,43,66,39,148
Oromia,East Hararge,Melka Belo,Nehase,12,2010,84,94,29,207
Oromia,West Guji,Hanbala,Ginbot,9,2009,22,83,17,122
Oromia,West Shewa,Codi,Ginbot,9,2010,0,22,74,96
Oromia,Guji,Saba Boru,Teqemt,2,2011,67,82,66,215
Oromia,Horo Gudru Wellega,Abe Dengoro,Sene,10,2010,0,0,44,44
Oromia,East Hararge,Babile Woreda,Ginbot,9,2009,24,15,71,110
Oromia,West Wellega,Begi,Tir,5,2009,9,57,89,155
Oromia,West Guji,Bule Hora Toun,Ginbot,9,2009,10,56,9,75
Oromia,Guji,Liben,Tir,5,2009,53,53,80,186
Oromia,Jimma,Tiro Afeta,Yekatit,6,2010,78,95,91,264
Oromia,West Arsi,Loke Hada Hospital,Meskerem,1,2011,75,80,75,230
Oromia,Arsi,Seru,Teqemt,2,2010,17,83,0,100
Oromia,Arsi,Hitosa,Nehase,12,2010,48,50,42,140
Oromia,East Shewa,Adea,Nehase,12,2010,13,88,51,152
Oromia,West Wellega,Ayira,Megabit,7,2009,96,67,90,253
Oromia,Horo Gudru Wellega,Amuru,Teqemt,2,2010,5,15,88,108
Oromia,West Arsi,Shala,Nehase,12,2009,25,5,36,66
Oromia,Gelan Town,Gelan Town,Hedar,3,2010,90,10,23,123
Oromia,Guji,Odo Shakiso,Hedar,3,2011,27,95,71,193
Oromia,West Shewa,Gindeberet Hospital,Megabit,7,2010,43,99,68,210
Oromia,Buno Bedele,Dedesa,Nehase,12,2010,13,1,81,95
Oromia,Arsi,Hitosa,Nehase,12,2010,83,90,21,194
Oromia,West Wellega,Gimbi Public  Hospital,Tir,5,2011,11,66,71,148
Oromia,Bale,Dawe Qachen,Ginbot,9,2009,56,72,85,213
Oromia,Buno Bedele,Chora,Yekatit,6,2009,90,36,17,143
Oromia,Guji,Aga Wayyu,Miyazia,8,2009,97,2,9,108
Oromia,Ilu Aba Bora,Metu Rural,Megabit,7,2009,12,79,76,167
Oromia,Qeleme Wellega,Hawa Gelan,Ginbot,9,2010,85,76,45,206
Oromia,West Guji,Dugda Dawa,Tir,5,2011,4,73,53,130
Oromia,Jimma,Dedo,Hedar,3,2010,79,43,12,134
Oromia,West Wellega,Boji Cheqorsa,Hedar,3,2011,83,6,8,97
Oromia,Qeleme Wellega,Seyo,Sene,10,2010,0,1,66,67
Oromia,Bishoftu Town,Bishoftu Town,Miyazia,8,2010,0,62,35,97
Oromia,East Hararge,Girawa,Hamle,11,2009,29,32,78,139
Oromia,Guji,Adola Hospital,Teqemt,2,2010,27,10,40,77
Oromia,Arsi,Chole,Nehase,12,2010,46,21,40,107
Oromia,Qeleme Wellega,Sedan Chanka,Megabit,7,2010,36,33,41,110
Oromia,East Hararge,Goro Muti,Yekatit,6,2010,18,67,32,117
Oromia,West Guji,Abaya,Sene,10,2010,99,92,54,245
Oromia,Qeleme Wellega,Laloqile,Ginbot,9,2009,59,61,33,153
Oromia,Horo Gudru Wellega,Abay Chomen,Ginbot,9,2009,64,35,89,188
Oromia,Horo Gudru Wellega,Abay Chomen,Sene,10,2010,60,8,24,92
Oromia,East Hararge,Chelenko Hospital,Nehase,12,2009,30,96,24,150
Oromia,West Shewa,Gojo Hospital,Teqemt,2,2010,24,32,87,143
Oromia,North Shewa,Yaya Gulele,Yekatit,6,2010,28,66,54,148
Oromia,Horo Gudru Wellega,Shambu Hospital,Ginbot,9,2010,65,99,16,180
Oromia,West Wellega,Qiltu Kara,Meskerem,1,2010,12,33,44,89
Oromia,Horo Gudru Wellega,Horo,Meskerem,1,2010,75,24,96,195
Oromia,West Hararge,Oda Bultum,Hamle,11,2009,96,11,67,174
Oromia,West Shewa,Dano,Ginbot,9,2010,99,57,37,193
Oromia,Arsi,Limuna Bilbilo,Teqemt,2,2010,41,96,4,141
Oromia,East Shewa,Fentale,Hamle,11,2010,94,44,75,213
Oromia,West Wellega,Ayira Hospital,Tir,5,2011,58,94,59,211
Oromia,Horo Gudru Wellega,Abay Chomen,Meskerem,1,2010,31,31,45,107
Oromia,West Guji,Gelana,Megabit,7,2011,13,60,97,170
Oromia,East Wellega,Ebantu,Miyazia,8,2011,47,2,89,138
Oromia,West Wellega,Ayira,Miyazia,8,2010,7,4,5,16
Oromia,Guji,Gumi Eldallo,Tir,5,2009,91,45,51,187
Oromia,Borena,Yabelo Hospital,Tir,5,2011,11,74,6,91
Oromia,East Wellega,Wayu Tuqa,Meskerem,1,2010,52,21,16,89
Oromia,Qeleme Wellega,Seyo,Sene,10,2011,16,31,56,103
Oromia,West Shewa,Dano,Hedar,3,2011,13,84,78,175
Oromia,West Hararge,Chiro Hospital,Yekatit,6,2010,90,94,93,277
Oromia,Arsi,Dodota,Ginbot,9,2009,39,20,2,61
Oromia,North Shewa,Hidabu Abote,Tahesas,4,2010,10,34,58,102
Oromia,West Guji,Abaya,Ginbot,9,2011,5,76,67,148
Oromia,West Shewa,Ejersa Lafo,Miyazia,8,2010,48,27,78,153
Oromia,Jimma,Kersa,Ginbot,9,2010,2,57,28,87
Oromia,North Shewa,Dera,Meskerem,1,2011,53,57,38,148
Oromia,Finfine Zuria,Mullo,Megabit,7,2010,53,51,80,184
Oromia,Guji,Adola Town,Ginbot,9,2009,12,4,73,89
Oromia,Bale,Ginir,Miyazia,8,2010,51,79,41,171
Oromia,North Shewa,Jido,Yekatit,6,2010,60,67,40,167
Oromia,Arsi,Aseko,Miyazia,8,2011,56,25,68,149
Oromia,Finfine Zuria,Mullo,Megabit,7,2009,84,29,85,198
Oromia,West Guji,Hanbala,Ginbot,9,2011,81,60,87,228
Oromia,West Guji,Bule Hora,Miyazia,8,2011,43,87,4,134
Oromia,Jimma Spe Town,Jimma Spe Town,Meskerem,1,2011,26,48,1,75
Oromia,West Shewa,Ilu Galan,Nehase,12,2009,24,59,38,121
Oromia,Arsi,Robe,Nehase,12,2010,41,5,36,82
Oromia,West Wellega,Gimbi Rural,Yekatit,6,2009,26,78,53,157
Oromia,East Hararge,Midega Tole,Meskerem,1,2010,55,23,2,80
Oromia,Arsi,Guna,Megabit,7,2009,6,64,56,126
Oromia,Jimma Spe Town,Jimma Spe Town,Ginbot,9,2009,22,96,1,119
Oromia,Guji,Wadara,Nehase,12,2010,60,75,39,174
Oromia,Borena,Yabelo Rural,Yekatit,6,2009,3,92,79,174
Oromia,West Wellega,Nejo Town,Yekatit,6,2009,59,33,80,172
Oromia,West Shewa,Guder Hosp,Ginbot,9,2010,73,91,64,228
Oromia,South West Shewa,St.Luke Hospital,Tir,5,2010,38,22,55,115
Oromia,Ambo Town,Ambo Town,Ginbot,9,2011,30,30,69,129
Oromia,West Wellega,Ayira Hospital,Hedar,3,2011,78,78,78,234
Oromia,Guji,Negele Hospital,Sene,10,2010,66,67,72,205
Oromia,West Guji,Dugda Dawa,Miyazia,8,2009,26,70,6,102
Oromia,Bale,Ginir,Sene,10,2009,65,87,95,247
Oromia,West Wellega,Mene Sibu,Ginbot,9,2011,69,10,66,145
Oromia,West Hararge,Boke,Megabit,7,2010,52,32,26,110
Oromia,Dukem Town,Dukem Town,Sene,10,2010,36,10,3,49
Oromia,East Shewa,Dugda,Meskerem,1,2010,72,96,55,223
Oromia,East Hararge,Melka Belo,Miyazia,8,2009,81,55,2,138
Oromia,Bale,Delo Mena,Ginbot,9,2009,10,69,75,154
Oromia,Guji,Adola Hospital,Ginbot,9,2009,92,70,52,214
Oromia,Arsi,Amigna,Tir,5,2009,10,71,62,143
Oromia,West Shewa,Bako Tibe,Megabit,7,2009,31,88,0,119
Oromia,Sululta Town,Sululta Town,Miyazia,8,2009,37,88,35,160
Oromia,East Wellega,Leqa Dulecha,Nehase,12,2009,67,75,21,163
Oromia,West Arsi,Shashemene Rural,Tahesas,4,2010,23,56,98,177
Oromia,East Hararge,Babile,Sene,10,2009,75,56,68,199
Oromia,East Wellega,Gida Ayana,Hamle,11,2009,2,50,64,116
Oromia,Ilu Aba Bora,Yayu,Megabit,7,2009,74,71,49,194
Oromia,Buno Bedele,Bedele Hospital,Hamle,11,2010,76,19,49,144
Oromia,West Arsi,Arsi Negele Rural,Hedar,3,2010,89,2,5,96
Oromia,Borena,Yabelo Rural,Sene,10,2011,0,92,3,95
Oromia,Horo Gudru Wellega,Hababo Guduru,Ginbot,9,2009,80,56,35,171
Oromia,West Guji,Dugda Dawa,Sene,10,2011,2,54,5,61
Oromia,Arsi,Bale Gesgara,Meskerem,1,2011,33,30,27,90
Oromia,Assela Town,Assela Town,Megabit,7,2009,66,20,91,177
Oromia,West Shewa,Ginde Beret,Teqemt,2,2011,83,44,91,218
Oromia,Horo Gudru Wellega,Chomen Guduru,Ginbot,9,2010,31,74,4,109
Oromia,Dukem Town,Dukem Town,Tahesas,4,2010,59,12,66,137
Oromia,West Arsi,Nensebo,Sene,10,2009,42,23,99,164
Oromia,East Hararge,Kersa Eh,Sene,10,2010,48,23,69,140
Oromia,Arsi,Munesa,Ginbot,9,2009,73,15,5,93
Oromia,West Shewa,Adea Berga,Ginbot,9,2011,36,53,28,117
Oromia,Bale,Goba,Tahesas,4,2010,55,38,5,98
Oromia,West Wellega,Guliso,Ginbot,9,2011,87,93,65,245
Oromia,East Hararge,Kombolicha,Miyazia,8,2010,89,44,42,175
Oromia,Ilu Aba Bora,Halu,Miyazia,8,2010,81,38,62,181
Oromia,East Shewa,Fentale,Miyazia,8,2009,10,27,56,93
Oromia,Bale,Dinsho,Sene,10,2011,95,7,54,156
Oromia,West Shewa,Ejersa Lafo,Ginbot,9,2010,31,11,3,45
Oromia,Guji,Hambela Wamena,Meskerem,1,2011,72,96,17,185
Oromia,West Shewa,Gedo Hospital,Meskerem,1,2011,97,95,10,202
Oromia,West Hararge,Gemechis,Sene,10,2011,5,15,95,115
Oromia,West Guji,Dugda Dawa,Sene,10,2011,61,14,91,166
Oromia,East Wellega,Leqa Dulecha,Hedar,3,2011,28,79,55,162
Oromia,Finfine Zuria,Berreh,Megabit,7,2010,30,97,24,151
Oromia,Arsi,Sude,Megabit,7,2010,6,57,39,102
Oromia,West Wellega,Qiltu Kara,Miyazia,8,2011,25,73,78,176
Oromia,North Shewa,Fichetown,Hedar,3,2011,98,58,83,239
Oromia,Assela Town,Assela Town,Yekatit,6,2009,95,59,64,218
Oromia,West Wellega,Gimbi,Ginbot,9,2009,8,29,50,87
Oromia,Finfine Zuria,Sebeta Awas,Tahesas,4,2010,78,17,67,162
Oromia,Finfine Zuria,Holeta,Miyazia,8,2009,98,84,62,244
Oromia,Arsi,Ludehetosa,Hamle,11,2010,12,30,95,137
Oromia,West Shewa,Ejersa Lafo,Hamle,11,2009,88,53,35,176
Oromia,Borena,Yabelo Hospital,Sene,10,2011,3,86,77,166
Oromia,Guji,Adola Reda,Megabit,7,2009,2,2,89,93
Oromia,West Arsi,Siraro,Yekatit,6,2010,26,60,91,177
Oromia,East Hararge,Babile Woreda,Miyazia,8,2009,97,78,26,201
Oromia,West Wellega,Genji,Miyazia,8,2010,97,91,28,216
Oromia,Arsi,Merti,Megabit,7,2010,49,70,18,137
Oromia,West Arsi,Kokosa,Ginbot,9,2011,93,11,94,198
Oromia,Guji,Negele Hospital,Megabit,7,2009,77,19,54,150
Oromia,Guji,Hambela Wamena,Miyazia,8,2011,77,71,80,228
Oromia,Horo Gudru Wellega,Jima Rare,Hedar,3,2011,13,98,42,153
Oromia,Qeleme Wellega,Dambi Dollo,Miyazia,8,2011,71,53,41,165
Oromia,Horo Gudru Wellega,Shambu Town,Megabit,7,2011,15,69,25,109
Oromia,West Hararge,Guba Qoricha,Teqemt,2,2011,57,85,95,237
Oromia,North Shewa,Hidabu Abote,Tir,5,2011,41,34,92,167
Oromia,Qeleme Wellega,Sedan Chanka,Tir,5,2011,96,58,87,241
Oromia,West Wellega,Mendi Town,Miyazia,8,2010,40,38,50,128
Oromia,Horo Gudru Wellega,Chomen Guduru,Ginbot,9,2011,6,86,4,96
Oromia,West Shewa,Dendi,Ginbot,9,2011,82,29,11,122
Oromia,East Wellega,Sibu Sire,Megabit,7,2009,1,37,90,128
Oromia,Jimma,O/Beyam,Tir,5,2010,52,22,11,85
Oromia,Jimma,Guma,Hedar,3,2011,26,14,57,97
Oromia,Arsi,Seru,Tahesas,4,2010,11,18,46,75
Oromia,Arsi,Guna,Megabit,7,2009,34,17,18,69
Oromia,Ilu Aba Bora,Hurumu,Megabit,7,2010,38,52,29,119
Oromia,North Shewa,Kimbibit,Sene,10,2009,88,95,39,222
Oromia,Dukem Town,Dukem Town,Hamle,11,2009,73,23,97,193
Oromia,South West Shewa,Woliso Rural,Hedar,3,2011,1,63,31,95
Oromia,South West Shewa,Wonchi,Yekatit,6,2010,74,70,45,189
Oromia,Bale,Ginir Town,Ginbot,9,2010,8,83,75,166
Oromia,Buno Bedele,Gechi,Megabit,7,2011,12,67,80,159
Oromia,West Wellega,Lalo Asabi,Ginbot,9,2009,97,77,9,183
Oromia,West Wellega,Seyo Nole,Tahesas,4,2011,88,8,76,172
Oromia,East Hararge,Haromaya Town,Tahesas,4,2010,46,53,76,175
Oromia,West Shewa,Codi,Sene,10,2011,66,70,25,161
Oromia,Arsi,Sude,Hamle,11,2010,73,31,31,135
Oromia,East Hararge,Midega Tole,Hedar,3,2011,57,63,46,166
Oromia,West Shewa,Midakegni,Meskerem,1,2011,67,90,94,251
Oromia,Borena,Moyale,Hamle,11,2009,50,29,7,86
Oromia,Bale,Seweyna,Sene,10,2010,43,9,57,109
Oromia,Borena,Yabelo,Hamle,11,2009,78,83,65,226
Oromia,West Wellega,Nole Kaba,Ginbot,9,2011,98,91,84,273
Oromia,Jimma,Gera,Yekatit,6,2009,27,26,83,136
Oromia,Adama Special Town,Adama Town,Meskerem,1,2011,70,49,50,169
Oromia,Qeleme Wellega,Sedan Chanka,Hedar,3,2010,17,51,46,114
Oromia,Arsi,Jeju,Nehase,12,2010,75,10,92,177
Oromia,Bale,Dawe Serar,Meskerem,1,2010,31,81,22,134
Oromia,West Shewa,Ambo Hospital,Meskerem,1,2010,16,68,73,157
Oromia,Arsi,Robe,Miyazia,8,2010,94,5,83,182
Oromia,East Hararge,Fedis,Sene,10,2011,60,82,5,147
Oromia,North Shewa,Dera,Teqemt,2,2010,92,9,18,119
Oromia,West Shewa,Liban Jawi,Meskerem,1,2010,51,8,43,102
Oromia,West Guji,Bule Hora,Miyazia,8,2010,26,12,22,60
Oromia,Arsi,Jeju,Miyazia,8,2009,3,41,53,97
Oromia,Bale,Gasera,Nehase,12,2010,8,19,62,89
Oromia,Jimma,Agaro,Yekatit,6,2009,84,32,41,157
Oromia,Finfine Zuria,Mullo,Miyazia,8,2010,85,70,38,193
Oromia,Arsi,Hitosa,Miyazia,8,2009,76,16,17,109
Oromia,North Shewa,Girar Jarso,Sene,10,2011,89,71,57,217
Oromia,Qeleme Wellega,Sedan Chanka,Meskerem,1,2011,83,38,10,131
Oromia,North Shewa,Aleiltu,Sene,10,2010,99,90,58,247
Oromia,East Wellega,Haro Limu,Miyazia,8,2011,87,65,49,201
Oromia,East Wellega,Wama Hagelo,Teqemt,2,2011,86,29,9,124
Oromia,East Hararge,Meta,Hedar,3,2011,32,43,74,149
Oromia,Lege Dadi Lege Tafo Town,Lege Dadi Lege Tafo Town,Tir,5,2011,98,81,12,191
Oromia,West Arsi,Siraro,Nehase,12,2010,34,67,14,115
Oromia,West Shewa,Ginde Beret,Tir,5,2010,54,88,61,203
Oromia,Bale,Legehida,Tir,5,2010,37,55,58,150
Oromia,Bale,Goba,Ginbot,9,2010,83,72,35,190
Oromia,Arsi,Jeju,Megabit,7,2009,16,61,34,111
Oromia,Finfine Zuria,Akaki,Hedar,3,2010,12,32,33,77
Oromia,Holeta Town,Holeta Town,Ginbot,9,2010,35,64,27,126
Oromia,East Hararge,Melka Belo,Nehase,12,2010,37,79,76,192
Oromia,Qeleme Wellega,Gidami,Yekatit,6,2011,19,26,51,96
Oromia,West Shewa,Adea Berga,Megabit,7,2011,7,99,7,113
Oromia,West Hararge,Chiro Zuriya,Megabit,7,2009,60,9,16,85
Oromia,West Shewa,Abuna Gindeberet,Nehase,12,2010,91,68,5,164
Oromia,Lege Dadi Lege Tafo Town,Lege Dadi Lege Tafo Town,Hedar,3,2010,70,92,45,207
Oromia,Bishoftu Town,Bishoftu Town,Hedar,3,2010,25,83,41,149
Oromia,Horo Gudru Wellega,Abe Dengoro,Hamle,11,2010,17,84,79,180
Oromia,East Hararge,Garemuleta Hospital,Miyazia,8,2011,67,22,83,172
Oromia,West Hararge,Habro,Miyazia,8,2009,81,10,72,163
Oromia,Adama Special Town,Adama Town,Nehase,12,2009,21,85,20,126
Oromia,West Wellega,Nejo Rural,Ginbot,9,2011,85,18,38,141
Oromia,Qeleme Wellega,Sedan Chanka,Ginbot,9,2010,64,16,84,164
Oromia,South West Shewa,Woliso Rural,Meskerem,1,2010,81,89,62,232
Oromia,West Shewa,Dano,Tir,5,2011,89,7,31,127
Oromia,West Wellega,Mendi Town,Tahesas,4,2011,75,7,36,118
Oromia,Ambo Town,Ambo Town,Tir,5,2011,24,95,81,200
Oromia,West Wellega,Gimbi,Ginbot,9,2010,29,20,82,131
Oromia,Qeleme Wellega,Anfilo,Sene,10,2011,51,5,60,116
Oromia,North Shewa,Hidabu Abote,Ginbot,9,2010,8,58,68,134
Oromia,East Wellega,Diga,Sene,10,2010,68,45,96,209
Oromia,East Hararge,Deder Town,Sene,10,2010,69,80,96,245
Oromia,Guji,Adola Reda,Tir,5,2010,0,80,66,146
Oromia,East Shewa,Batu,Sene,10,2009,94,45,56,195
Oromia,West Guji,Kercha Hospital,Ginbot,9,2010,29,89,43,161
Oromia,Horo Gudru Wellega,Amuru,Tir,5,2009,98,25,92,215
Oromia,East Hararge,Haromaya Rural,Tahesas,4,2011,63,3,9,75
Oromia,Borena,El Way,Tahesas,4,2011,76,34,25,135
Oromia,Qeleme Wellega,Laloqile,Miyazia,8,2011,74,35,67,176
Oromia,Buno Bedele,Dedesa,Tahesas,4,2010,35,25,44,104
Oromia,Dukem Town,Dukem Town,Tir,5,2010,15,1,41,57
Oromia,West Wellega,Nejo Rural,Miyazia,8,2009,39,28,69,136
Oromia,West Hararge,Oda Bultum,Megabit,7,2010,9,52,50,111
Oromia,East Wellega,Leqa Dulecha,Hamle,11,2009,95,84,65,244
Oromia,Qeleme Wellega,Dale Wabera,Yekatit,6,2011,14,97,92,203
Oromia,Sululta Town,Sululta Town,Nehase,12,2009,90,8,52,150
Oromia,Guji,Saba Boru,Miyazia,8,2010,55,28,67,150
Oromia,Qeleme Wellega,Dambi Dolo Hospital,Tahesas,4,2010,59,27,41,127
Oromia,Qeleme Wellega,Dambi Dollo,Megabit,7,2010,82,0,84,166
Oromia,West Arsi,Gambo Hospital,Miyazia,8,2011,86,90,60,236
Oromia,West Guji,Suro Barguda,Hamle,11,2009,92,95,77,264
Oromia,West Hararge,Mesela,Hamle,11,2009,18,42,23,83
Oromia,Borena,Dhas,Hamle,11,2010,38,39,71,148
Oromia,Borena,Meyo,Teqemt,2,2011,77,37,36,150
Oromia,West Wellega,Mendi Hospital,Teqemt,2,2011,58,84,47,189
Oromia,East Wellega,Boneya Bushe,Nehase,12,2009,87,20,29,136
Oromia,West Hararge,Boke,Meskerem,1,2011,64,14,19,97
Oromia,North Shewa,Dera,Sene,10,2011,10,25,82,117
Oromia,Jimma,O/Beyam,Sene,10,2010,78,38,43,159
Oromia,West Wellega,Genji,Yekatit,6,2011,26,69,63,158
Oromia,East Wellega,Sasiga,Tahesas,4,2010,31,70,74,175
Oromia,West Shewa,Ejersa Lafo,Megabit,7,2009,43,21,99,163
Oromia,West Guji,Bule Hora,Sene,10,2011,47,50,33,130
Oromia,North Shewa,Were Jarso,Ginbot,9,2009,88,8,75,171
Oromia,West Arsi,Dodola Town,Teqemt,2,2010,33,62,23,118
Oromia,Bale,Goro,Sene,10,2010,54,39,55,148
Oromia,Arsi,Deksis,Miyazia,8,2010,98,89,80,267
Oromia,Qeleme Wellega,Dambi Dollo,Tir,5,2009,20,82,87,189
Oromia,West Shewa,Codi,Tir,5,2011,17,24,76,117
Oromia,West Arsi,Shala,Yekatit,6,2011,62,36,9,107
Oromia,Buno Bedele,Chewaqa,Nehase,12,2010,11,23,22,56
Oromia,West Wellega,Gimbi Rural,Tahesas,4,2011,79,79,61,219
Oromia,West Guji,Dugda Dawa,Miyazia,8,2011,55,34,21,110
Oromia,West Wellega,Kundala,Nehase,12,2010,22,39,84,145
Oromia,West Shewa,Jeldu,Yekatit,6,2009,86,37,77,200
Oromia,West Shewa,Abuna Gindeberet,Hedar,3,2011,20,11,61,92
Oromia,Jimma,Setema,Hamle,11,2009,91,54,60,205
Oromia,West Hararge,Mesela,Ginbot,9,2010,48,58,6,112
Oromia,Ilu Aba Bora,Nono Sele,Tahesas,4,2011,41,31,79,151
Oromia,Buno Bedele,Gechi,Miyazia,8,2011,63,68,93,224
Oromia,Bale,Raitu,Miyazia,8,2011,6,12,72,90
Oromia,East Wellega,Ebantu,Sene,10,2009,47,18,89,154
Oromia,Arsi,Amigna,Megabit,7,2010,93,23,57,173
Oromia,West Arsi,Loke Hada Hospital,Ginbot,9,2011,89,93,62,244
Oromia,West Wellega,Nejo Rural,Sene,10,2011,64,35,78,177
Oromia,Jimma,Omonada,Hedar,3,2010,91,75,95,261
Oromia,Ilu Aba Bora,Ale,Megabit,7,2009,2,56,3,61
Oromia,West Shewa,Gindeberet Hospital,Tir,5,2010,2,26,69,97
Oromia,West Guji,Biebirsa Kojowa,Hedar,3,2011,54,22,43,119
Oromia,West Arsi,Dodola Town,Hedar,3,2011,72,89,94,255
Oromia,Buno Bedele,Boricha,Meskerem,1,2011,32,7,88,127
Oromia,Horo Gudru Wellega,Amuru,Nehase,12,2010,14,93,97,204
Oromia,Arsi,Seru,Ginbot,9,2011,94,34,76,204
Oromia,East Wellega,Boneya Bushe,Megabit,7,2011,93,96,63,252
Oromia,West Wellega,Haru,Miyazia,8,2010,22,63,33,118
Oromia,Borena,Dhas,Nehase,12,2009,77,71,10,158
Oromia,West Arsi,Dodola Rural,Miyazia,8,2009,12,66,3,81
Oromia,Finfine Zuria,Sululta Town,Hamle,11,2010,28,98,80,206
Oromia,Jimma Spe Town,Jimma Spe Town,Tahesas,4,2010,23,62,12,97
Oromia,East Shewa,Mojo,Tir,5,2009,96,89,80,265
Oromia,West Shewa,Bako Tibe,Tir,5,2011,79,90,12,181
Oromia,West Hararge,Meiso,Teqemt,2,2010,25,85,29,139
Oromia,West Shewa,Midakegni,Hamle,11,2009,92,64,90,246
Oromia,Horo Gudru Wellega,Abay Chomen,Tir,5,2009,67,80,61,208
Oromia,Guji,Bore Hospital,Tir,5,2011,14,49,13,76
Oromia,North Shewa,Kuyu,Ginbot,9,2010,16,38,45,99
Oromia,Bale,Goba Town,Meskerem,1,2010,34,1,50,85
Oromia,West Wellega,Kundala,Tir,5,2011,22,90,12,124
Oromia,North Shewa,Dera Hospital,Hedar,3,2010,2,69,33,104
Oromia,Arsi,Munesa,Tir,5,2009,35,25,61,121
Oromia,West Wellega,Guliso,Tir,5,2011,8,34,37,79
Oromia,Ilu Aba Bora,Bure,Megabit,7,2011,36,63,1,100
Oromia,Bale,Legehida,Sene,10,2009,70,7,9,86
Oromia,East Hararge,Bedeno,Ginbot,9,2010,19,92,61,172
Oromia,Jimma,Shabe,Megabit,7,2010,28,39,41,108
Oromia,Borena,El Way,Hedar,3,2011,46,62,69,177
Oromia,West Hararge,Doba,Tir,5,2009,72,30,94,196
Oromia,West Wellega,Nejo Hospital,Megabit,7,2010,30,23,53,106
Oromia,Qeleme Wellega,Dale Wabera,Ginbot,9,2011,99,4,78,181
Oromia,East Hararge,Kumbi,Meskerem,1,2010,47,94,97,238
Oromia,Arsi,Aseko,Tir,5,2010,98,42,11,151
Oromia,West Hararge,Boke,Tahesas,4,2010,35,77,32,144
Oromia,Ilu Aba Bora,Halu,Nehase,12,2009,34,18,70,122
Oromia,Arsi,Deksis,Tahesas,4,2011,93,93,97,283
Oromia,Qeleme Wellega,Gidami,Ginbot,9,2009,21,20,16,57
Oromia,West Arsi,Nensebo,Nehase,12,2009,2,62,93,157
Oromia,West Wellega,Nole Kaba,Yekatit,6,2011,5,41,50,96
Oromia,Ilu Aba Bora,Darimu,Miyazia,8,2011,18,96,6,120
Oromia,West Wellega,Haru,Ginbot,9,2011,67,95,24,186
Oromia,West Wellega,Mene Sibu,Tir,5,2011,70,25,13,108
Oromia,Ilu Aba Bora,Hurumu,Sene,10,2011,10,27,62,99
Oromia,West Hararge,Hawi Gudina,Tahesas,4,2010,63,0,81,144
Oromia,Arsi,Munesa,Hamle,11,2009,49,11,61,121
Oromia,Horo Gudru Wellega,Abay Chomen,Nehase,12,2010,91,15,10,116
Oromia,Buno Bedele,Boricha,Tir,5,2011,38,2,13,53
Oromia,West Shewa,Inchini Hospital,Miyazia,8,2009,97,70,56,223
Oromia,Buno Bedele,Meko,Nehase,12,2009,48,2,34,84
Oromia,West Shewa,Bako Hospital,Yekatit,6,2011,60,88,44,192
Oromia,Guji,Goro Dola,Meskerem,1,2010,82,68,16,166
Oromia,Arsi,Hitosa,Sene,10,2009,39,71,93,203
Oromia,Horo Gudru Wellega,Jima Rare,Miyazia,8,2009,39,48,46,133
Oromia,Borena,Dubluk,Megabit,7,2009,21,92,35,148
Oromia,West Wellega,Nole Kaba,Nehase,12,2009,35,59,5,99
Oromia,West Wellega,Jarso,Ginbot,9,2010,44,15,76,135
Oromia,West Arsi,Gedeb Asasa,Meskerem,1,2011,44,33,45,122
Oromia,Ilu Aba Bora,Hurumu,Tir,5,2011,24,28,27,79
Oromia,West Shewa,Meta Waliqite,Megabit,7,2010,45,63,18,126
Oromia,West Wellega,Guliso,Tahesas,4,2010,73,92,80,245
Oromia,Ilu Aba Bora,Bure,Yekatit,6,2011,63,86,12,161
Oromia,East Hararge,Gursum,Miyazia,8,2011,19,40,15,74
Oromia,Bale,Gasera,Teqemt,2,2010,95,27,47,169
Oromia,West Wellega,Begi,Ginbot,9,2009,57,26,21,104
Oromia,West Arsi,Kore,Teqemt,2,2011,90,2,86,178
Oromia,West Arsi,Loke Hada Hospital,Tir,5,2011,22,54,57,133
Oromia,Ilu Aba Bora,Becho,Tahesas,4,2010,52,87,96,235
Oromia,East Wellega,Diga,Megabit,7,2011,61,14,80,155
Oromia,Jimma,Limu Seka,Tir,5,2009,88,78,52,218
Oromia,East Shewa,Dugda,Megabit,7,2009,38,33,69,140
Oromia,East Hararge,Babile Woreda,Sene,10,2011,54,28,12,94
Oromia,Horo Gudru Wellega,Jarte Jardga,Miyazia,8,2011,35,3,69,107
Oromia,Borena,Gomole,Tir,5,2011,14,71,4,89
Oromia,West Arsi,Dodola Town,Tir,5,2009,92,98,79,269
Oromia,West Arsi,Bishan Guracha Town,Sene,10,2009,46,54,15,115
Oromia,West Guji,Kercha,Meskerem,1,2011,52,30,38,120
Oromia,East Hararge,Chinakesen,Miyazia,8,2009,50,60,61,171
Oromia,West Wellega,Nole Kaba,Miyazia,8,2010,13,54,31,98
Oromia,Jimma,Sekoru,Ginbot,9,2009,61,91,4,156
Oromia,East Hararge,Babile,Megabit,7,2010,16,79,56,151
Oromia,West Shewa,Ginde Beret,Megabit,7,2010,41,93,39,173
Oromia,East Hararge,Chinakesen,Megabit,7,2009,48,21,58,127
Oromia,West Wellega,Yubdo,Hamle,11,2010,41,1,69,111
Oromia,West Shewa,Liban Jawi,Ginbot,9,2010,92,9,30,131
Oromia,East Hararge,Meyu Muleke,Yekatit,6,2010,21,86,62,169
Oromia,Guji,Adola Reda,Megabit,7,2011,80,7,0,87
Oromia,West Wellega,Mendi Hospital,Miyazia,8,2010,80,3,79,162
Oromia,North Shewa,Yaya Gulele,Yekatit,6,2009,89,50,21,160
Oromia,Bale,Legehida,Ginbot,9,2011,46,18,97,161
Oromia,Buno Bedele,Diga,Hamle,11,2010,66,3,81,150
Oromia,Bale,Dawe Serar,Megabit,7,2009,9,18,20,47
Oromia,Arsi,Guna,Miyazia,8,2011,2,22,9,33
Oromia,West Guji,Abaya,Tir,5,2011,1,52,22,75
Oromia,West Wellega,Genji,Megabit,7,2009,56,89,8,153
Oromia,East Hararge,Deder,Yekatit,6,2009,0,55,3,58
Oromia,East Wellega,Leqa Dulecha,Teqemt,2,2011,69,28,82,179
Oromia,West Wellega,Gimbi Rural,Megabit,7,2010,86,5,38,129
Oromia,Borena,Dubluk,Miyazia,8,2011,2,7,45,54
Oromia,Buno Bedele,Bedele Zuriya,Yekatit,6,2010,44,56,73,173
Oromia,West Wellega,Gimbi,Tahesas,4,2010,93,94,28,215
Oromia,Jimma,O/Beyam,Ginbot,9,2011,42,42,3,87
Oromia,West Arsi,Kokosa,Megabit,7,2010,79,62,42,183
Oromia,West Hararge,Boke,Miyazia,8,2010,36,52,82,170
Oromia,West Hararge,Chiro Town,Yekatit,6,2010,91,71,63,225
Oromia,East Hararge,Babile Woreda,Ginbot,9,2011,27,83,50,160
Oromia,South West Shewa,Tole,Meskerem,1,2011,15,70,27,112
Oromia,Jimma,Nono Benja,Miyazia,8,2011,28,53,23,104
Oromia,Horo Gudru Wellega,Hababo Guduru,Sene,10,2009,44,63,94,201
Oromia,East Hararge,Garemuleta Hospital,Nehase,12,2009,71,82,12,165
Oromia,South West Shewa,St.Luke Hospital,Teqemt,2,2010,43,98,28,169
Oromia,Ilu Aba Bora,Yayu,Ginbot,9,2010,74,14,48,136
Oromia,Ilu Aba Bora,Bilonopa,Tir,5,2011,5,4,51,60
Oromia,West Hararge,Meiso,Miyazia,8,2010,33,25,80,138
Oromia,Jimma,Limu Hospital,Megabit,7,2010,5,32,35,72
Oromia,Arsi,Hitosa,Teqemt,2,2011,39,98,83,220
Oromia,Arsi,Shirka,Miyazia,8,2011,12,52,78,142
Oromia,West Wellega,Nole Kaba,Tahesas,4,2010,17,48,1,66
Oromia,Guji,Adola Town,Yekatit,6,2009,51,43,24,118
Oromia,Horo Gudru Wellega,Horo,Miyazia,8,2011,57,13,77,147
Oromia,East Hararge,Aweday Town,Ginbot,9,2011,62,42,29,133
Oromia,West Guji,Kercha Hospital,Hamle,11,2010,69,64,25,158
Oromia,West Wellega,Seyo Nole,Hedar,3,2011,50,31,19,100
Oromia,West Shewa,Meta Waliqite,Megabit,7,2011,70,14,93,177
Oromia,West Wellega,Boji Cheqorsa,Sene,10,2009,66,64,86,216
Oromia,Qeleme Wellega,Gidami,Ginbot,9,2009,12,71,88,171
Oromia,West Shewa,Jibat,Yekatit,6,2011,70,99,95,264
Oromia,West Arsi,Gambo Hospital,Ginbot,9,2009,10,10,78,98
Oromia,North Shewa,Hidabu Abote,Teqemt,2,2010,66,3,41,110
Oromia,North Shewa,Hidabu Abote,Ginbot,9,2010,75,20,9,104
Oromia,West Wellega,Begi,Sene,10,2010,28,33,40,101
Oromia,West Guji,Gelana,Ginbot,9,2011,30,1,43,74
Oromia,Arsi,Enkelo Wabe,Tir,5,2011,50,38,93,181
Oromia,Jimma,Agaro Hospital,Tir,5,2011,17,49,68,134
Oromia,West Arsi,Shashemene Rural,Megabit,7,2010,15,30,12,57
Oromia,West Arsi,Kore,Hedar,3,2010,74,31,62,167
Oromia,East Hararge,Chelenko Hospital,Tir,5,2009,78,14,50,142
Oromia,Ilu Aba Bora,Doreni,Ginbot,9,2009,74,81,27,182
Oromia,Buno Bedele,Bedele Zuriya,Miyazia,8,2011,39,98,50,187
Oromia,Arsi,Seru,Ginbot,9,2011,71,18,68,157
Oromia,East Shewa,Boset,Ginbot,9,2011,90,76,64,230
Oromia,Arsi,Dodota,Hedar,3,2011,80,55,23,158
Oromia,East Hararge,Meyu Muleke,Tir,5,2011,2,63,48,113
Oromia,Borena,Yabelo Rural,Hamle,11,2010,48,79,14,141
Oromia,West Hararge,Boke,Tir,5,2009,2,17,99,118
Oromia,East Hararge,Goro Gutu,Megabit,7,2010,75,19,70,164
Oromia,Horo Gudru Wellega,Jima Rare,Megabit,7,2009,98,84,0,182
Oromia,Arsi,Bekoji Town,Megabit,7,2009,69,94,29,192
Oromia,Dukem Town,Dukem Town,Ginbot,9,2009,97,20,73,190
Oromia,East Shewa,Lomme,Nehase,12,2010,57,2,38,97
Oromia,West Hararge,Meiso,Ginbot,9,2011,27,54,59,140
Oromia,East Shewa,Adami Tulu Jido Kombolcha,Megabit,7,2011,51,84,68,203
Oromia,West Hararge,Mesela,Miyazia,8,2011,86,6,67,159
Oromia,Arsi,Ludehetosa,Ginbot,9,2009,83,48,85,216
Oromia,West Shewa,Ambo Hospital,Miyazia,8,2011,89,15,6,110
Oromia,West Wellega,Boji Cheqorsa,Ginbot,9,2009,69,33,73,175
Oromia,East Wellega,Sasiga,Tir,5,2010,82,92,74,248
Oromia,Ilu Aba Bora,Becho,Hedar,3,2010,29,16,37,82
Oromia,Bale,Gololcha,Tir,5,2009,83,25,64,172
Oromia,Bale,Goro,Meskerem,1,2011,36,51,91,178
Oromia,East Hararge,Melka Belo,Hedar,3,2010,59,82,12,153
Oromia,West Shewa,Metarobi,Ginbot,9,2010,68,45,30,143
Oromia,Borena,Wachile,Miyazia,8,2010,38,35,80,153
Oromia,West Shewa,Gedo Hospital,Hedar,3,2010,50,60,72,182
Oromia,East Hararge,Gole Oda,Megabit,7,2010,96,67,9,172
Oromia,West Shewa,Ilu Galan,Yekatit,6,2010,19,45,8,72
Oromia,West Guji,Bule Hora Hospital,Meskerem,1,2011,74,97,35,206
Oromia,Finfine Zuria,Sandefa,Ginbot,9,2011,16,96,41,153
Oromia,East Hararge,Kumbi,Meskerem,1,2011,0,82,86,168
Oromia,Arsi,Bekoji Town,Hamle,11,2010,18,65,30,113
Oromia,West Hararge,Gelemso Hospital,Nehase,12,2009,86,64,69,219
Oromia,West Shewa,Ejerie,Tir,5,2010,11,75,46,132
Oromia,Horo Gudru Wellega,Gudru,Nehase,12,2009,16,48,43,107
Oromia,West Shewa,Ginde Beret,Megabit,7,2011,22,39,76,137
Oromia,West Arsi,Wondo,Nehase,12,2009,28,87,45,160
Oromia,Jimma,Limu Hospital,Meskerem,1,2010,22,5,19,46
Oromia,East Hararge,Meyu Muleke,Teqemt,2,2010,64,23,96,183
Oromia,Qeleme Wellega,Dale Sedi,Meskerem,1,2011,84,32,91,207
Oromia,Jimma,Omonada,Teqemt,2,2011,98,31,95,224
Oromia,West Arsi,Kore,Teqemt,2,2011,59,40,20,119
Oromia,Qeleme Wellega,Hawa Gelan,Tir,5,2009,45,99,69,213
Oromia,East Shewa,Gimbichu,Megabit,7,2010,79,63,95,237
Oromia,Qeleme Wellega,Dale Wabera,Hedar,3,2011,87,78,39,204
Oromia,West Wellega,Nole Kaba,Hedar,3,2011,6,69,37,112
Oromia,West Hararge,Oda Bultum,Ginbot,9,2009,12,16,50,78
Oromia,Jimma,Omonada,Sene,10,2010,26,59,91,176
Oromia,West Arsi,Dodola Town,Ginbot,9,2011,13,57,23,93
Oromia,West Wellega,Haru,Tir,5,2010,9,91,90,190
Oromia,Burayu Town,Burayu Town,Hamle,11,2010,85,56,36,177
Oromia,West Shewa,Codi,Tir,5,2011,44,42,54,140
Oromia,Qeleme Wellega,Seyo,Teqemt,2,2010,16,52,35,103
Oromia,East Wellega,Sibu Sire,Megabit,7,2011,18,85,17,120
Oromia,Bale,Ginir,Tir,5,2011,20,88,51,159
Oromia,Bale,Berbere,Miyazia,8,2009,28,42,53,123
Oromia,Jimma,Dedo,Megabit,7,2009,73,49,64,186
Oromia,Finfine Zuria,Akaki,Megabit,7,2011,58,75,40,173
Oromia,West Guji,Gelana,Ginbot,9,2011,32,93,54,179
Oromia,West Wellega,Mendi Town,Megabit,7,2010,39,45,56,140
Oromia,Modjo Town,Modjo Town,Tahesas,4,2010,29,25,83,137
Oromia,Jimma,Limu Hospital,Miyazia,8,2009,11,21,61,93
Oromia,Horo Gudru Wellega,Abe Dengoro,Miyazia,8,2011,73,14,48,135
Oromia,West Shewa,Dano,Megabit,7,2009,99,7,41,147
Oromia,Jimma,Setema,Yekatit,6,2009,82,31,25,138
Oromia,Arsi,Ludehetosa,Meskerem,1,2010,68,47,12,127
Oromia,Dukem Town,Dukem Town,Tahesas,4,2010,63,18,96,177
Oromia,West Wellega,Babo Gembel,Hedar,3,2010,78,68,34,180
Oromia,West Shewa,Metarobi,Megabit,7,2009,18,0,94,112
Oromia,East Hararge,Bisidimo Hospital,Miyazia,8,2009,25,9,37,71
Oromia,West Arsi,Wondo,Tir,5,2009,92,0,10,102
Oromia,Jimma,Seka Chhokorsa Hospital,Megabit,7,2011,74,68,26,168
Oromia,West Shewa,Codi,Megabit,7,2010,16,90,54,160
Oromia,West Shewa,Ambo Hospital,Hedar,3,2011,43,35,64,142
Oromia,West Wellega,Gimbi,Nehase,12,2010,73,99,75,247
Oromia,South West Shewa,Bantu  Hospital,Ginbot,9,2010,20,28,40,88
Oromia,Arsi,Deksis,Megabit,7,2009,95,56,26,177
Oromia,Buno Bedele,Bedele Town,Tir,5,2010,50,50,73,173
Oromia,Buno Bedele,Meko,Meskerem,1,2010,2,96,81,179
Oromia,West Arsi,Hebal Arsi,Hamle,11,2009,42,18,65,125
Oromia,East Hararge,Gursum,Sene,10,2011,69,93,49,211
Oromia,Borena,Meyo,Tir,5,2010,99,72,69,240
Oromia,South West Shewa,Goro,Yekatit,6,2009,12,68,46,126
Oromia,East Hararge,Kombolicha,Ginbot,9,2009,88,91,34,213
Oromia,Arsi,Aseko,Tir,5,2011,13,95,29,137
Oromia,West Shewa,Jibat,Sene,10,2010,98,27,70,195
Oromia,Shashamane Town,Shashamane Town,Tahesas,4,2011,98,23,83,204
Oromia,West Guji,Bule Hora Toun,Sene,10,2009,8,4,94,106
Oromia,West Arsi,Wondo,Teqemt,2,2010,34,87,55,176
Oromia,Borena,Dire,Miyazia,8,2011,61,46,15,122
Oromia,Jimma,Limu Kosa,Hedar,3,2010,60,21,36,117
Oromia,West Arsi,Kore,Sene,10,2010,38,14,2,54
Oromia,West Guji,Mkelka Soda,Meskerem,1,2010,90,84,43,217
Oromia,East Shewa,Dugda,Teqemt,2,2010,81,10,77,168
Oromia,Ilu Aba Bora,Hurumu,Nehase,12,2010,15,99,99,213
Oromia,West Arsi,Wondo,Tir,5,2011,66,8,45,119
Oromia,West Wellega,Begi,Ginbot,9,2011,92,83,72,247
Oromia,Jimma,Limu Seka,Meskerem,1,2010,1,86,91,178
Oromia,Borena,Teltele,Hamle,11,2010,53,6,85,144
Oromia,West Shewa,Jibat,Hamle,11,2009,8,32,68,108
Oromia,West Wellega,Guliso,Tir,5,2010,31,63,93,187
Oromia,West Shewa,Guder Hosp,Tir,5,2009,52,91,97,240
Oromia,West Shewa,Codi,Tir,5,2011,8,69,10,87
Oromia,Bale,Ginir,Yekatit,6,2010,80,57,7,144
Oromia,Qeleme Wellega,Dale Sedi,Meskerem,1,2010,95,45,33,173
Oromia,Jimma,Tiro Afeta,Megabit,7,2011,53,4,11,68
Oromia,East Shewa,Boset,Megabit,7,2011,68,85,30,183
Oromia,West Shewa,Metarobi,Tir,5,2009,8,50,52,110
Oromia,Arsi,Deksis,Ginbot,9,2011,59,97,46,202
Oromia,Borena,Wachile,Tahesas,4,2011,77,37,35,149
Oromia,East Wellega,Gida Ayana,Sene,10,2010,65,97,24,186
Oromia,Jimma,Sigmo,Miyazia,8,2009,3,34,85,122
Oromia,Ilu Aba Bora,Metu Rural,Yekatit,6,2011,46,4,90,140
Oromia,West Shewa,Bako Tibe,Hedar,3,2010,44,37,90,171
Oromia,Jimma Spe Town,Jimma Spe Town,Megabit,7,2010,42,37,63,142
Oromia,Bale,Delo Mena,Sene,10,2010,66,71,70,207
Oromia,West Shewa,Ambo University  Hosp,Ginbot,9,2011,67,21,19,107
Oromia,West Guji,Bule Hora Hospital,Tir,5,2010,71,95,3,169
Oromia,Bale,Sinana,Nehase,12,2009,91,13,7,111
Oromia,East Shewa,Olanciti Hospital,Sene,10,2009,39,90,63,192
Oromia,South West Shewa,Woliso Rural,Hamle,11,2010,59,29,24,112
Oromia,East Hararge,Deder Hospital,Megabit,7,2010,18,78,98,194
Oromia,West Shewa,Ilu Galan,Yekatit,6,2011,34,33,36,103
Oromia,Ilu Aba Bora,Darimu,Hedar,3,2011,40,64,68,172
Oromia,East Wellega,Kiremu,Miyazia,8,2011,41,39,60,140
Oromia,North Shewa,Kuyu,Ginbot,9,2010,56,6,56,118
Oromia,Buno Bedele,Boricha,Hamle,11,2009,58,23,57,138
Oromia,North Shewa,Yaya Gulele,Megabit,7,2010,17,75,4,96
Oromia,Jimma,Gomma,Yekatit,6,2010,52,6,50,108
Oromia,West Guji,Kercha,Miyazia,8,2010,96,2,28,126
Oromia,North Shewa,Dera,Megabit,7,2010,69,32,33,134
Oromia,West Wellega,Mendi Hospital,Teqemt,2,2010,20,59,95,174
Oromia,Horo Gudru Wellega,Hababo Guduru,Tir,5,2010,92,27,88,207
Oromia,West Hararge,Anchar,Hedar,3,2011,3,34,72,109
Oromia,South West Shewa,Wonchi,Tir,5,2011,64,56,81,201
Oromia,West Wellega,Nejo Hospital,Tahesas,4,2011,2,72,57,131
Oromia,Bale,Dawe Serar,Megabit,7,2010,18,2,65,85
Oromia,Sebeta Town,Sebeta Town,Miyazia,8,2010,4,84,6,94
Oromia,East Wellega,Guto Gida,Nehase,12,2010,43,98,45,186
Oromia,Borena,Wachile,Tir,5,2010,33,51,35,119
Oromia,West Guji,Abaya,Nehase,12,2009,45,94,3,142
Oromia,West Shewa,Jeldu,Miyazia,8,2011,26,8,48,82
Oromia,West Shewa,Gedo Hospital,Megabit,7,2009,81,80,68,229
Oromia,Ilu Aba Bora,Metu Rural,Tir,5,2011,3,93,48,144
Oromia,Bale,Gololcha,Hedar,3,2010,19,25,96,140
Oromia,Ilu Aba Bora,Becho,Tir,5,2011,76,34,76,186
Oromia,West Hararge,Chiro Hospital,Ginbot,9,2009,23,56,3,82
Oromia,East Wellega,Sibu Sire,Hedar,3,2011,6,14,52,72
Oromia,Guji,Adola Reda,Hamle,11,2010,56,25,31,112
Oromia,North Shewa,Fiche Hospital,Megabit,7,2011,91,42,54,187
Oromia,North Shewa,Kuyu Hospital,Ginbot,9,2009,54,14,99,167
Oromia,Buno Bedele,Chewaqa,Yekatit,6,2010,53,11,68,132
Oromia,Arsi,Bale Gesgara,Yekatit,6,2010,71,15,7,93
Oromia,West Arsi,Shashemene Rural,Ginbot,9,2011,1,73,17,91
Oromia,East Wellega,Diga,Miyazia,8,2010,92,79,23,194
Oromia,North Shewa,Wuchale,Nehase,12,2010,76,85,11,172
Oromia,Jimma,Mana,Nehase,12,2009,34,52,61,147
Oromia,West Hararge,Chiro Hospital,Hedar,3,2011,85,42,29,156
Oromia,Qeleme Wellega,Gidami Hosp,Yekatit,6,2011,23,90,80,193
Oromia,East Shewa,Gimbichu,Tahesas,4,2011,0,10,72,82
Oromia,West Arsi,Kofele,Ginbot,9,2010,47,63,11,121
Oromia,Jimma,Setema Hospital,Yekatit,6,2011,67,89,67,223
Oromia,West Hararge,Mesela,Teqemt,2,2010,30,41,6,77
Oromia,Borena,Meyo,Tahesas,4,2011,83,53,53,189
Oromia,East Shewa,Liben,Yekatit,6,2010,91,52,87,230
Oromia,West Wellega,Nejo Hospital,Hedar,3,2010,58,84,93,235
Oromia,Jimma,Mana,Sene,10,2009,69,38,16,123
Oromia,East Wellega,Wama Hagelo,Tir,5,2009,26,78,63,167
Oromia,Guji,Saba Boru,Megabit,7,2011,30,91,3,124
Oromia,West Wellega,Nejo Hospital,Yekatit,6,2011,25,25,32,82
Oromia,Qeleme Wellega,Dale Sedi,Meskerem,1,2011,94,90,71,255
Oromia,Borena,Yabelo Hospital,Hamle,11,2010,25,80,83,188
Oromia,Buno Bedele,Bedele Hospital,Nehase,12,2010,96,45,34,175
Oromia,West Wellega,Mendi Town,Miyazia,8,2010,23,65,29,117
Oromia,Holeta Town,Holeta Town,Tahesas,4,2011,84,7,30,121
Oromia,Qeleme Wellega,Dale Sedi,Ginbot,9,2010,31,72,91,194
Oromia,Guji,Dima,Meskerem,1,2011,99,97,33,229
Oromia,West Arsi,Shashemene Rural,Nehase,12,2010,86,10,79,175
Oromia,West Guji,Biebirsa Kojowa,Teqemt,2,2010,76,60,37,173
Oromia,Gelan Town,Gelan Town,Hedar,3,2011,2,79,24,105
Oromia,East Hararge,Jarso,Meskerem,1,2010,99,21,80,200
Oromia,Arsi,Ludehetosa,Tir,5,2009,30,9,44,83
Oromia,East Wellega,Limu,Miyazia,8,2011,21,41,29,91
Oromia,Arsi,Amigna,Sene,10,2009,6,91,72,169
Oromia,West Arsi,Adaba,Meskerem,1,2010,43,47,10,100
Oromia,Arsi,Guna,Tir,5,2009,49,17,9,75
Oromia,West Hararge,Habro,Miyazia,8,2009,26,99,95,220
Oromia,West Arsi,Hebal Arsi,Megabit,7,2009,55,79,69,203
Oromia,Sululta Town,Sululta Town,Yekatit,6,2009,27,79,23,129
Oromia,Arsi,Sude,Yekatit,6,2010,83,60,14,157
Oromia,Guji,Hambela Wamena,Yekatit,6,2011,71,94,39,204
Oromia,Bale,Gasera,Yekatit,6,2010,69,62,72,203
Oromia,North Shewa,Kuyu Hospital,Sene,10,2009,96,38,27,161
Oromia,South West Shewa,Wonchi,Ginbot,9,2009,99,98,96,293
Oromia,Qeleme Wellega,Dambi Dolo Hospital,Teqemt,2,2011,91,22,29,142
Oromia,West Guji,Mkelka Soda,Hamle,11,2010,29,38,67,134
Oromia,West Guji,Suro Barguda,Yekatit,6,2010,46,43,67,156
Oromia,East Shewa,Lomme,Yekatit,6,2009,33,71,4,108
Oromia,Qeleme Wellega,Dale Sedi,Nehase,12,2010,82,89,48,219
Oromia,Sululta Town,Sululta Town,Yekatit,6,2010,15,86,93,194
Oromia,Bale,Dawe Qachen,Miyazia,8,2011,43,35,21,99
Oromia,Bale,Gololcha,Miyazia,8,2010,80,9,39,128
Oromia,North Shewa,Aleiltu,Ginbot,9,2010,74,30,97,201
Oromia,East Hararge,Kurfa Chele,Miyazia,8,2011,45,85,29,159
Oromia,Arsi,Munesa,Tir,5,2011,81,15,62,158
Oromia,West Hararge,Gelemso Hospital,Ginbot,9,2010,88,36,66,190
Oromia,Bale,Arena Buluq,Miyazia,8,2009,5,22,11,38
Oromia,Ilu Aba Bora,Didu,Sene,10,2009,87,67,47,201
Oromia,Arsi,Ludehetosa,Miyazia,8,2009,17,45,87,149
Oromia,West Shewa,Elifata,Hamle,11,2010,57,58,31,146
Oromia,Guji,Girja,Tir,5,2011,25,15,0,40
Oromia,East Hararge,Kombolicha,Megabit,7,2009,50,45,78,173
Oromia,West Wellega,Nejo Hospital,Yekatit,6,2009,2,70,80,152
Oromia,Borena,Arero,Tir,5,2011,95,67,56,218
Oromia,Guji,Uraga,Hamle,11,2010,66,97,80,243
Oromia,East Shewa,Liben,Teqemt,2,2010,31,79,7,117
Oromia,Assela Town,Assela Town,Nehase,12,2010,54,57,39,150
Oromia,South West Shewa,Ilu,Tir,5,2011,84,34,40,158
Oromia,North Shewa,Abichugna,Hedar,3,2011,73,73,73,219
Oromia,Guji,Adola Town,Tir,5,2009,69,12,16,97
Oromia,Finfine Zuria,Sululta Town,Tir,5,2011,54,86,85,225
Oromia,Qeleme Wellega,Gidami,Tahesas,4,2011,36,61,12,109
Oromia,Qeleme Wellega,Yemalogi Wolel,Hamle,11,2010,70,96,33,199
Oromia,East Hararge,Babile,Sene,10,2011,68,16,88,172
Oromia,West Arsi,Dodola Town,Sene,10,2010,95,1,9,105
Oromia,West Shewa,Ambo,Tahesas,4,2010,27,15,64,106
Oromia,West Wellega,Homa,Tahesas,4,2011,40,5,14,59
Oromia,Lege Dadi Lege Tafo Town,Lege Dadi Lege Tafo Town,Meskerem,1,2011,95,45,28,168
Oromia,South West Shewa,Sodo Dac'Ha,Miyazia,8,2011,93,2,30,125
Oromia,South West Shewa,Bantu  Hospital,Nehase,12,2010,59,23,24,106
Oromia,Guji,Odo Shakiso,Miyazia,8,2011,35,57,37,129
Oromia,Guji,Anna Sora,Hedar,3,2010,64,62,47,173
Oromia,Buno Bedele,Chewaqa,Hedar,3,2011,42,98,46,186
Oromia,Arsi,Munesa,Hamle,11,2010,73,35,73,181
Oromia,Ilu Aba Bora,Becho,Ginbot,9,2009,9,36,10,55
Oromia,West Shewa,Inchini Hospital,Sene,10,2011,56,45,36,137
Oromia,East Wellega,Gudeyabila,Hamle,11,2009,76,54,87,217
Oromia,Sebeta Town,Sebeta Town,Nehase,12,2010,91,96,34,221
Oromia,Ilu Aba Bora,Bure,Sene,10,2009,77,37,15,129
Oromia,East Hararge,Babile Woreda,Miyazia,8,2011,34,72,58,164
Oromia,Arsi,Digeluna Tijo,Yekatit,6,2010,82,91,92,265
Oromia,Arsi,Sire,Hedar,3,2011,69,56,40,165
Oromia,Horo Gudru Wellega,Horro Buluk,Tir,5,2011,97,28,30,155
Oromia,Gelan Town,Gelan Town,Yekatit,6,2010,13,12,43,68
Oromia,West Shewa,Midakegni,Nehase,12,2010,86,69,82,237
Oromia,East Wellega,Nunu Qumba,Ginbot,9,2010,7,84,10,101
Oromia,Jimma,Limu Kosa,Sene,10,2009,45,72,41,158
Oromia,Guji,Liben,Ginbot,9,2010,88,53,55,196
Oromia,Jimma,Nono Benja,Megabit,7,2011,90,69,66,225
Oromia,Arsi,Dodota,Nehase,12,2010,59,41,3,103
Oromia,West Arsi,Kokosa,Yekatit,6,2011,86,60,81,227
Oromia,West Shewa,Abuna Gindeberet,Tir,5,2009,48,48,29,125
Oromia,East Shewa,Adea,Sene,10,2011,49,89,98,236
Oromia,East Hararge,Midega Tole,Hedar,3,2011,19,39,5,63
Oromia,West Arsi,Shashemene Rural,Tahesas,4,2011,12,51,10,73
Oromia,Finfine Zuria,Berreh,Tahesas,4,2010,29,47,42,118
Oromia,North Shewa,Aleiltu,Tahesas,4,2010,53,11,38,102
Oromia,East Hararge,Deder,Tir,5,2010,61,14,96,171
Oromia,West Arsi,Wondo,Miyazia,8,2009,16,85,57,158
Oromia,North Shewa,Hidabu Abote,Miyazia,8,2011,10,42,78,130
Oromia,Arsi,Merti,Sene,10,2011,86,80,94,260
Oromia,West Wellega,Mendi Hospital,Megabit,7,2011,66,81,48,195
Oromia,South West Shewa,Seden Sodo,Sene,10,2011,70,0,11,81
Oromia,East Shewa,Bora,Hamle,11,2010,60,73,85,218
Oromia,Arsi,Seru,Ginbot,9,2010,37,4,89,130
Oromia,Horo Gudru Wellega,Chomen Guduru,Miyazia,8,2010,35,4,80,119
Oromia,Ilu Aba Bora,Nono Sele,Hedar,3,2010,99,81,71,251
Oromia,Woliso Town,Woliso Town,Sene,10,2011,27,25,84,136
Oromia,West Hararge,Chiro Hospital,Nehase,12,2010,80,61,96,237
Oromia,West Hararge,Gelemso Hospital,Teqemt,2,2010,56,29,21,106
Oromia,East Shewa,Batu,Nehase,12,2010,33,8,99,140
Oromia,Jimma,Limu Hospital,Hamle,11,2009,2,28,84,114
Oromia,West Wellega,Babo Gembel,Hamle,11,2010,12,18,44,74
Oromia,Jimma,Seka Chekorsa,Hamle,11,2009,34,44,6,84
Oromia,South West Shewa,St.Luke Hospital,Yekatit,6,2009,79,53,56,188
Oromia,Horo Gudru Wellega,Horro Buluk,Ginbot,9,2011,77,86,37,200
Oromia,West Guji,Bule Hora Hospital,Nehase,12,2009,56,18,72,146
Oromia,East Wellega,Limu,Yekatit,6,2009,51,59,29,139
Oromia,Horo Gudru Wellega,Abay Chomen,Yekatit,6,2010,77,8,26,111
Oromia,Jimma,Nono Benja,Hedar,3,2010,2,39,53,94
Oromia,South West Shewa,Tole,Nehase,12,2009,14,84,21,119
Oromia,West Shewa,Ejersa Lafo,Teqemt,2,2011,47,85,92,224
Oromia,Assela Town,Assela Town,Sene,10,2009,21,69,68,158
Oromia,Burayu Town,Burayu Town,Hamle,11,2009,77,88,94,259
Oromia,South West Shewa,Becho,Hedar,3,2010,14,74,9,97
Oromia,Qeleme Wellega,Hawa Gelan,Hedar,3,2011,41,86,59,186
Oromia,Buno Bedele,Chewaqa,Sene,10,2009,22,30,49,101
Oromia,East Hararge,Haromaya Hospital,Ginbot,9,2010,90,93,35,218
Oromia,Arsi,Digeluna Tijo,Teqemt,2,2011,8,76,14,98
Oromia,West Guji,Suro Barguda,Hedar,3,2010,87,64,3,154
Oromia,East Wellega,Guto Gida,Ginbot,9,2011,92,56,88,236
Oromia,East Shewa,Adami Tulu Jido Kombolcha,Miyazia,8,2009,72,29,99,200
Oromia,Bale,Raitu,Ginbot,9,2009,14,7,33,54
Oromia,Arsi,Dodota,Megabit,7,2011,39,53,41,133
Oromia,Arsi,Sire,Hamle,11,2009,6,31,12,49
Oromia,West Arsi,Shashemene Rural,Tir,5,2009,96,56,97,249
Oromia,West Shewa,Codi,Yekatit,6,2011,10,93,57,160
Oromia,Guji,Negele Hospital,Tir,5,2011,0,11,50,61
Oromia,Bale,Legehida,Teqemt,2,2010,56,21,36,113
Oromia,West Shewa,Midakegni,Ginbot,9,2011,93,37,40,170
Oromia,Bale,Legehida,Yekatit,6,2009,76,88,22,186
Oromia,East Shewa,Adami Tulu Jido Kombolcha,Hamle,11,2010,85,8,88,181
Oromia,Arsi,Zeway Dugda,Ginbot,9,2009,29,16,59,104
Oromia,North Shewa,Degem,Teqemt,2,2011,42,68,22,132
Oromia,East Hararge,Gursum,Miyazia,8,2011,6,45,24,75
Oromia,Horo Gudru Wellega,Jima Rare,Megabit,7,2010,67,40,19,126
Oromia,Guji,Goro Dola,Ginbot,9,2011,84,43,92,219
Oromia,Borena,Moyale,Teqemt,2,2010,6,68,30,104
Oromia,West Wellega,Nole Kaba,Megabit,7,2009,86,55,1,142
Oromia,East Hararge,Chelenko Hospital,Hedar,3,2010,59,78,84,221
Oromia,East Hararge,Chelenko Hospital,Tahesas,4,2010,64,40,97,201
Oromia,Arsi,Shirka,Megabit,7,2009,40,10,10,60
Oromia,West Shewa,Abuna Gindeberet,Yekatit,6,2010,73,26,55,154
Oromia,Ilu Aba Bora,Metu Town,Yekatit,6,2009,35,31,22,88
Oromia,West Wellega,Boji Dermeji,Miyazia,8,2009,96,52,30,178
Oromia,East Hararge,Haromaya Hospital,Miyazia,8,2010,16,67,78,161
Oromia,East Hararge,Midega Tole,Ginbot,9,2011,1,90,8,99
Oromia,Ilu Aba Bora,Bure,Ginbot,9,2009,46,67,63,176
Oromia,Qeleme Wellega,Yemalogi Wolel,Meskerem,1,2011,61,23,24,108
Oromia,South West Shewa,Ameya,Tir,5,2010,11,38,74,123
Oromia,Qeleme Wellega,Gawo Qebe,Hedar,3,2011,65,58,72,195
Oromia,East Shewa,Boset,Teqemt,2,2011,36,58,60,154
Oromia,East Shewa,Adami Tulu Jido Kombolcha,Teqemt,2,2010,2,92,16,110
Oromia,East Shewa,Bora,Miyazia,8,2010,48,99,28,175
Oromia,East Hararge,Kurfa Chele,Teqemt,2,2011,22,89,6,117
Oromia,South West Shewa,Dawo,Sene,10,2009,94,93,67,254
Oromia,West Hararge,Tulo,Sene,10,2010,51,14,11,76
Oromia,West Hararge,Gelemso Hospital,Meskerem,1,2011,79,2,71,152
Oromia,West Hararge,Chiro Town,Miyazia,8,2009,70,89,28,187
Oromia,West Hararge,Bedesa Town,Ginbot,9,2009,74,55,94,223
Oromia,Jimma,Setema Hospital,Tir,5,2011,7,2,83,92
Oromia,Ilu Aba Bora,Didu,Tahesas,4,2010,6,43,81,130
Oromia,Finfine Zuria,Sululta Town,Miyazia,8,2010,74,99,49,222
Oromia,West Wellega,Seyo Nole,Hedar,3,2010,67,47,22,136
Oromia,South West Shewa,Seden Sodo,Sene,10,2010,65,87,58,210
Oromia,North Shewa,Aleiltu,Yekatit,6,2011,60,93,75,228
Oromia,West Wellega,Genji,Sene,10,2009,38,30,69,137
Oromia,Lege Dadi Lege Tafo Town,Lege Dadi Lege Tafo Town,Nehase,12,2010,7,63,81,151
Oromia,North Shewa,Abichugna,Megabit,7,2009,61,83,14,158
Oromia,Ilu Aba Bora,Metu Town,Miyazia,8,2011,11,24,78,113
Oromia,West Wellega,Kundala,Yekatit,6,2011,19,9,11,39
Oromia,Sebeta Town,Sebeta Town,Nehase,12,2010,56,49,32,137
Oromia,Jimma,Setema,Hedar,3,2010,76,22,13,111
Oromia,Qeleme Wellega,Dambi Dolo Hospital,Miyazia,8,2010,95,71,32,198
Oromia,West Shewa,Ambo,Miyazia,8,2010,80,87,14,181
Oromia,North Shewa,Aleiltu,Tir,5,2011,40,45,56,141
Oromia,Finfine Zuria,Walmera,Meskerem,1,2011,99,37,54,190
Oromia,West Arsi,Gedeb Asasa,Ginbot,9,2009,23,41,41,105
Oromia,North Shewa,Dera,Sene,10,2009,29,26,81,136
Oromia,West Guji,Abaya,Yekatit,6,2010,51,25,14,90
Oromia,Buno Bedele,Chewaqa,Yekatit,6,2009,21,38,40,99
Oromia,North Shewa,Dera,Sene,10,2010,41,64,37,142
Oromia,Bale,Raitu,Tir,5,2011,50,50,87,187
Oromia,West Shewa,Gedo Hospital,Ginbot,9,2010,58,79,31,168
Oromia,Qeleme Wellega,Gidami Hosp,Hedar,3,2011,86,48,78,212
Oromia,Qeleme Wellega,Gawo Qebe,Megabit,7,2009,83,73,17,173
Oromia,Ilu Aba Bora,Nono Sele,Ginbot,9,2010,12,92,54,158
Oromia,West Shewa,Metarobi,Miyazia,8,2010,36,93,86,215
Oromia,West Shewa,Ilu Galan,Hamle,11,2009,17,28,36,81
Oromia,Bale,Goba Town,Megabit,7,2010,26,72,70,168
Oromia,Bale,Gasera,Ginbot,9,2009,4,78,40,122
Oromia,Holeta Town,Holeta Town,Nehase,12,2010,91,31,8,130
Oromia,Bale,Seweyna,Yekatit,6,2011,9,75,39,123
Oromia,North Shewa,Were Jarso,Nehase,12,2009,0,66,81,147
Oromia,West Wellega,Mendi Hospital,Nehase,12,2009,79,16,49,144
Oromia,West Wellega,Mendi Town,Miyazia,8,2009,80,10,44,134
Oromia,Arsi,Chole,Megabit,7,2010,5,98,35,138
Oromia,West Hararge,Bedesa Town,Megabit,7,2010,28,79,67,174
Oromia,Arsi,Merti,Miyazia,8,2011,88,63,68,219
Oromia,West Shewa,Dano,Sene,10,2009,94,75,57,226
Oromia,Guji,Liben,Ginbot,9,2011,82,80,69,231
Oromia,Arsi,Aseko,Hamle,11,2009,79,66,6,151
Oromia,Bale,Gasera,Nehase,12,2010,93,21,24,138
Oromia,Ilu Aba Bora,Didu,Yekatit,6,2010,41,48,95,184
Oromia,South West Shewa,Tole,Yekatit,6,2009,61,65,84,210
Oromia,Horo Gudru Wellega,Hababo Guduru,Nehase,12,2009,95,9,12,116
Oromia,West Wellega,Gimbi Rural,Nehase,12,2010,59,24,14,97
Oromia,Bale,Gura Dhamole,Hedar,3,2011,22,9,57,88
Oromia,Arsi,Deksis,Meskerem,1,2011,11,52,40,103
Oromia,Borena,Guchi,Meskerem,1,2010,32,5,67,104
Oromia,Buno Bedele,Boricha,Miyazia,8,2010,3,17,9,29
Oromia,Bale,Agarfa,Nehase,12,2009,19,29,75,123
Oromia,Jimma,Gomma,Ginbot,9,2011,79,69,78,226
Oromia,Jimma Spe Town,Jimma Spe Town,Megabit,7,2011,76,35,49,160
Oromia,West Arsi,Hebal Arsi,Megabit,7,2009,98,44,26,168
Oromia,Jimma,Gera,Yekatit,6,2011,41,12,5,58
Oromia,West Guji,Dugda Dawa,Yekatit,6,2010,19,86,52,157
Oromia,North Shewa,Jido,Miyazia,8,2011,84,87,6,177
Oromia,West Guji,Biebirsa Kojowa,Tahesas,4,2011,52,29,62,143
Oromia,Borena,Moyale,Tir,5,2009,19,79,90,188
Oromia,Ilu Aba Bora,Halu,Sene,10,2009,25,76,85,186
Oromia,West Hararge,Gelemso Hospital,Nehase,12,2010,44,54,42,140
Oromia,Bale,Raitu,Meskerem,1,2011,3,13,63,79
Oromia,West Hararge,Oda Bultum,Megabit,7,2011,38,91,41,170
Oromia,Qeleme Wellega,Gawo Qebe,Hedar,3,2010,51,58,75,184
Oromia,East Shewa,Liben,Sene,10,2009,42,39,65,146
Oromia,East Hararge,Haromaya Hospital,Yekatit,6,2009,97,77,24,198
Oromia,Finfine Zuria,Mullo,Hedar,3,2010,22,21,45,88
Oromia,Arsi,Merti,Miyazia,8,2011,42,26,95,163
Oromia,South West Shewa,Woliso Rural,Yekatit,6,2010,69,61,86,216
Oromia,West Wellega,Seyo Nole,Nehase,12,2009,15,74,99,188
Oromia,Arsi,Sire,Hedar,3,2010,16,98,33,147
Oromia,East Hararge,Haromaya Hospital,Miyazia,8,2010,66,33,38,137
Oromia,West Hararge,Anchar,Sene,10,2009,69,14,67,150
Oromia,East Shewa,Liben,Yekatit,6,2010,67,81,16,164
Oromia,Jimma,Gera,Sene,10,2010,97,9,51,157
Oromia,Ilu Aba Bora,Algesachi,Miyazia,8,2011,76,86,84,246
Oromia,Arsi,Bale Gesgara,Hedar,3,2011,52,67,60,179
Oromia,Jimma,Chora Boter,Tahesas,4,2010,43,36,93,172
Oromia,East Hararge,Deder Town,Nehase,12,2010,89,79,50,218
Oromia,Jimma,Omonada,Tir,5,2010,93,16,12,121
Oromia,Horo Gudru Wellega,Gudru,Tir,5,2011,0,49,23,72
Oromia,North Shewa,Girar Jarso,Yekatit,6,2010,45,18,10,73
Oromia,Guji,Aga Wayyu,Ginbot,9,2009,0,47,28,75
Oromia,Arsi,Sire,Hedar,3,2010,35,71,51,157
Oromia,Arsi,Bale Gesgara,Ginbot,9,2010,35,4,64,103
Oromia,West Shewa,Gindeberet Hospital,Tir,5,2011,95,88,14,197
Oromia,West Wellega,Gimbi,Megabit,7,2010,52,30,40,122
Oromia,Arsi,Munesa,Teqemt,2,2011,41,49,87,177
Oromia,East Hararge,Haromaya Town,Ginbot,9,2011,78,78,94,250
Oromia,Horo Gudru Wellega,Amuru,Miyazia,8,2009,50,13,12,75
Oromia,Jimma,B/Tolyi,Sene,10,2009,66,19,59,144
Oromia,Finfine Zuria,Sebeta Awas,Hamle,11,2010,22,4,71,97
Oromia,North Shewa,Fiche Hospital,Megabit,7,2011,19,44,53,116
Oromia,Guji,Negele Hospital,Hamle,11,2009,11,55,87,153
Oromia,Ilu Aba Bora,Didu,Yekatit,6,2010,23,62,72,157
Oromia,Bale,Goro,Yekatit,6,2011,65,17,43,125
Oromia,West Wellega,Qiltu Kara,Yekatit,6,2011,39,69,25,133
Oromia,West Arsi,Dodola Town,Yekatit,6,2009,48,37,96,181
Oromia,Qeleme Wellega,Seyo,Meskerem,1,2010,47,73,0,120
Oromia,East Shewa,Fentale,Teqemt,2,2010,86,87,96,269
Oromia,Sebeta Town,Sebeta Town,Tir,5,2009,85,58,43,186
Oromia,Arsi,Merti,Megabit,7,2009,51,74,12,137
Oromia,East Wellega,Jimma Arjo,Tahesas,4,2010,28,20,12,60
Oromia,West Shewa,Ambo,Yekatit,6,2009,10,54,44,108
Oromia,West Shewa,Ejersa Lafo,Meskerem,1,2011,1,80,39,120
Oromia,South West Shewa,Woliso Rural,Sene,10,2009,8,56,16,80
Oromia,Buno Bedele,Meko,Teqemt,2,2011,29,0,72,101
Oromia,West Arsi,Dodola Rural,Miyazia,8,2011,74,72,60,206
Oromia,West Hararge,Doba,Sene,10,2011,28,36,2,66
Oromia,Horo Gudru Wellega,Chomen Guduru,Teqemt,2,2010,70,94,40,204
Oromia,East Shewa,Liben,Megabit,7,2009,69,60,42,171
Oromia,East Hararge,Kumbi,Yekatit,6,2011,25,39,25,89
Oromia,Guji,Hambela Wamena,Tir,5,2011,68,18,34,120
Oromia,Bale,Gololcha,Miyazia,8,2011,41,15,19,75
Oromia,Nekemte Town,Nekemte Town,Tahesas,4,2011,66,75,15,156
Oromia,West Guji,Hanbala,Sene,10,2010,57,52,89,198
Oromia,Ilu Aba Bora,Doreni,Tir,5,2011,17,51,7,75
Oromia,Jimma,Guma,Tahesas,4,2010,52,29,72,153
Oromia,Ilu Aba Bora,Metu Rural,Yekatit,6,2009,98,3,55,156
Oromia,East Wellega,Haro Limu,Yekatit,6,2010,7,21,51,79
Oromia,Bale,Berbere,Yekatit,6,2009,45,65,71,181
Oromia,Bale,Meda Welabu,Sene,10,2009,55,18,27,100
Oromia,West Guji,Bule Hora,Ginbot,9,2011,3,71,96,170
Oromia,West Hararge,West Harerge	Gumbi Bordede,Tir,5,2009,30,40,40,110
Oromia,Horo Gudru Wellega,Amuru,Megabit,7,2010,42,92,61,195
Oromia,Qeleme Wellega,Seyo,Yekatit,6,2009,0,32,15,47
Oromia,South West Shewa,Ameya,Ginbot,9,2010,2,77,98,177
Oromia,East Hararge,Meyu Muleke,Yekatit,6,2009,6,61,55,122
Oromia,West Shewa,Ejersa Lafo,Meskerem,1,2011,5,62,46,113
Oromia,East Shewa,Adama,Megabit,7,2009,92,69,25,186
Oromia,Arsi,Merti,Ginbot,9,2011,83,60,14,157
Oromia,Bale,Raitu,Tir,5,2010,86,80,50,216
Oromia,Buno Bedele,Boricha,Hamle,11,2009,55,32,89,176
Oromia,Borena,Wachile,Teqemt,2,2010,89,79,50,218
Oromia,East Hararge,Haromaya Rural,Tir,5,2011,82,58,29,169
Oromia,Bale,Arena Buluq,Nehase,12,2010,47,14,88,149
Oromia,Guji,Negele Town,Teqemt,2,2010,37,60,47,144
Oromia,East Hararge,Kombolicha,Teqemt,2,2010,87,86,2,175
Oromia,East Hararge,Gole Oda,Hamle,11,2010,20,88,90,198
Oromia,West Arsi,Kofele,Megabit,7,2010,20,99,35,154
Oromia,Bale,Raitu,Yekatit,6,2009,92,11,22,125
Oromia,East Wellega,Diga,Tir,5,2010,80,44,70,194
Oromia,West Shewa,Tikur Enchini,Yekatit,6,2009,50,47,97,194
Oromia,East Hararge,Fedis,Tir,5,2011,54,63,40,157
Oromia,Dukem Town,Dukem Town,Tahesas,4,2011,41,79,42,162
Oromia,Qeleme Wellega,Jimma Horo,Teqemt,2,2011,87,92,86,265
Oromia,East Hararge,Deder Town,Sene,10,2009,8,80,80,168
Oromia,Jimma,Gera,Ginbot,9,2010,71,15,26,112
Oromia,West Guji,Bule Hora Toun,Teqemt,2,2010,78,97,30,205
Oromia,East Wellega,Sasiga,Sene,10,2010,73,90,57,220
Oromia,Qeleme Wellega,Jimma Horo,Yekatit,6,2009,31,39,59,129
Oromia,Arsi,Guna,Miyazia,8,2009,68,65,91,224
Oromia,Jimma,Setema,Miyazia,8,2011,97,50,77,224
Oromia,Arsi,Amigna,Tir,5,2010,15,16,59,90
Oromia,East Hararge,Garemuleta Hospital,Ginbot,9,2010,64,16,39,119
Oromia,Buno Bedele,Bedele Zuriya,Miyazia,8,2009,80,21,52,153
Oromia,Buno Bedele,Dapho Hana,Yekatit,6,2010,92,98,68,258
Oromia,South West Shewa,Tulu Bolo Hospital,Nehase,12,2010,44,98,97,239
Oromia,East Hararge,Garemuleta Hospital,Tir,5,2011,8,58,34,100
Oromia,Bale,Delo Mena,Sene,10,2009,53,62,97,212
Oromia,West Arsi,Kofele,Tir,5,2010,67,67,58,192
Oromia,East Hararge,Goro Gutu,Tahesas,4,2011,16,81,58,155
Oromia,Finfine Zuria,Sebeta Awas,Ginbot,9,2011,33,95,86,214
Oromia,Horo Gudru Wellega,Abe Dengoro,Hedar,3,2011,73,81,87,241
Oromia,East Hararge,Meta,Yekatit,6,2009,43,23,45,111
Oromia,West Wellega,Gimbi Adventist Hospital,Ginbot,9,2011,71,96,2,169
Oromia,East Wellega,Wayu Tuqa,Hedar,3,2011,99,15,89,203
Oromia,West Arsi,Arsi Negele Rural,Tir,5,2010,58,8,29,95
Oromia,West Wellega,Guliso,Sene,10,2010,47,63,44,154
Oromia,Arsi,Deksis,Sene,10,2009,1,1,23,25
Oromia,Borena,Teltele,Teqemt,2,2011,48,20,0,68
Oromia,Guji,Negele Town,Ginbot,9,2010,61,97,70,228
Oromia,Jimma,Mancho,Yekatit,6,2011,15,38,17,70
Oromia,Buno Bedele,Bedele Town,Tahesas,4,2011,42,61,71,174
Oromia,West Wellega,Nejo Town,Nehase,12,2010,39,9,32,80
Oromia,West Guji,Kercha Hospital,Miyazia,8,2010,10,51,0,61
Oromia,Arsi,Digeluna Tijo,Meskerem,1,2010,58,15,11,84
Oromia,West Shewa,Chelia,Tahesas,4,2010,41,15,62,118
Oromia,Adama Special Town,Adama Town,Ginbot,9,2009,73,3,11,87
Oromia,Guji,Dima,Ginbot,9,2010,26,84,26,136
Oromia,Guji,Shakiso Town,Megabit,7,2009,32,36,89,157
Oromia,East Hararge,Aweday Town,Nehase,12,2009,13,28,75,116
Oromia,West Shewa,Ginde Beret,Tir,5,2010,67,13,68,148
Oromia,Guji,Dima,Megabit,7,2009,77,31,74,182
Oromia,West Wellega,Mendi Hospital,Yekatit,6,2010,87,82,12,181
Oromia,East Hararge,Bisidimo Hospital,Tir,5,2010,76,80,31,187
Oromia,East Wellega,Haro Limu,Ginbot,9,2011,95,11,6,112
Oromia,Jimma,Sigmo,Hedar,3,2010,58,81,85,224
Oromia,Qeleme Wellega,Seyo,Tir,5,2009,98,19,81,198
Oromia,East Wellega,Sibu Sire,Tir,5,2010,84,38,8,130
Oromia,East Shewa,Lomme,Sene,10,2009,62,73,60,195
Oromia,West Arsi,Loke Hada Hospital,Nehase,12,2010,97,17,54,168
Oromia,East Hararge,Deder,Tir,5,2009,77,73,67,217
Oromia,North Shewa,Debre Libanos,Tir,5,2009,0,96,90,186
Oromia,Bale,Arena Buluq,Tahesas,4,2011,79,60,33,172
Oromia,East Hararge,Kombolicha,Ginbot,9,2010,89,6,0,95
Oromia,Ilu Aba Bora,Bure,Sene,10,2009,2,84,9,95
Oromia,Bale,Agarfa,Tir,5,2011,84,37,89,210
Oromia,Arsi,Jeju,Tir,5,2011,1,44,65,110
Oromia,East Hararge,Haromaya Hospital,Ginbot,9,2011,92,4,47,143
Oromia,Gelan Town,Gelan Town,Tir,5,2011,64,47,74,185
Oromia,East Shewa,Gimbichu,Hedar,3,2010,13,94,78,185
Oromia,Bale,Goro,Tahesas,4,2010,58,13,25,96
Oromia,West Shewa,Bako Tibe,Sene,10,2009,54,84,70,208
Oromia,Borena,Gomole,Meskerem,1,2010,91,35,62,188
Oromia,West Hararge,Chiro Town,Hamle,11,2010,41,36,40,117
Oromia,East Hararge,Chelenko Hospital,Hamle,11,2009,16,40,1,57
Oromia,Arsi,Bale Gesgara,Hamle,11,2009,25,86,96,207
Oromia,East Hararge,Babile Woreda,Meskerem,1,2011,80,6,9,95
Oromia,West Shewa,Liban Jawi,Teqemt,2,2011,67,29,28,124
Oromia,West Shewa,Chelia,Tahesas,4,2011,49,14,76,139
Oromia,East Hararge,Garemuleta Hospital,Hedar,3,2010,16,1,58,75
Oromia,West Wellega,Lalo Asabi,Ginbot,9,2011,93,79,62,234
Oromia,Sebeta Town,Sebeta Town,Sene,10,2009,63,77,12,152
Oromia,North Shewa,Dera,Megabit,7,2011,68,53,51,172
Oromia,North Shewa,Kimbibit,Ginbot,9,2011,75,0,56,131
Oromia,Horo Gudru Wellega,Abay Chomen,Ginbot,9,2010,72,68,60,200
Oromia,Lege Dadi Lege Tafo Town,Lege Dadi Lege Tafo Town,Tahesas,4,2010,68,10,90,168
Oromia,Jimma,Mancho,Meskerem,1,2011,62,84,6,152
Oromia,Bale,Goro,Yekatit,6,2010,12,67,86,165
Oromia,Holeta Town,Holeta Town,Yekatit,6,2011,77,17,57,151
Oromia,East Shewa,Liben,Hamle,11,2010,79,5,96,180
Oromia,Borena,El Way,Yekatit,6,2010,4,94,93,191
Oromia,West Arsi,Adaba,Tir,5,2010,69,15,32,116
Oromia,Buno Bedele,Dapho Hana,Nehase,12,2010,13,51,89,153
Oromia,Adama Special Town,Adama Town,Teqemt,2,2011,15,93,10,118
Oromia,Jimma,Mana,Ginbot,9,2009,43,14,72,129
Oromia,South West Shewa,Becho,Ginbot,9,2009,14,47,71,132
Oromia,East Hararge,Jarso,Miyazia,8,2009,90,44,0,134
Oromia,West Arsi,Wondo,Miyazia,8,2009,30,9,16,55
Oromia,West Guji,Kercha Hospital,Sene,10,2010,51,20,18,89
Oromia,Horo Gudru Wellega,Shambu Hospital,Hedar,3,2010,30,43,42,115
Oromia,North Shewa,Dera Hospital,Tir,5,2011,7,62,23,92
Oromia,North Shewa,Were Jarso,Meskerem,1,2010,78,31,73,182
Oromia,South West Shewa,St.Luke Hospital,Miyazia,8,2011,93,39,11,143
Oromia,West Shewa,Gindeberet Hospital,Ginbot,9,2010,71,81,98,250
Oromia,Jimma,B/Tolyi,Tahesas,4,2011,49,35,19,103
Oromia,West Shewa,Jibat,Nehase,12,2009,58,33,57,148
Oromia,Horo Gudru Wellega,Abay Chomen,Ginbot,9,2011,13,6,32,51
Oromia,East Wellega,Jimma Arjo,Tir,5,2011,5,20,42,67
Oromia,East Wellega,Diga,Tahesas,4,2010,70,81,67,218
Oromia,Finfine Zuria,Akaki,Teqemt,2,2011,91,78,21,190
Oromia,Buno Bedele,Bedele Zuriya,Tir,5,2009,57,0,2,59
Oromia,East Shewa,Lomme,Ginbot,9,2009,62,66,94,222
Oromia,East Wellega,Jimma Arjo,Meskerem,1,2010,60,44,81,185
Oromia,Arsi,Zeway Dugda,Tahesas,4,2010,83,65,69,217
Oromia,East Wellega,Limu,Sene,10,2009,17,16,88,121
Oromia,West Shewa,Inchini Hospital,Tahesas,4,2010,12,87,76,175
Oromia,Buno Bedele,Chora,Meskerem,1,2010,61,53,85,199
Oromia,East Shewa,Matahara,Hedar,3,2010,70,82,37,189
Oromia,West Wellega,Yubdo,Meskerem,1,2010,25,4,91,120
Oromia,Arsi,Merti,Teqemt,2,2010,42,8,79,129
Oromia,West Wellega,Nejo Rural,Meskerem,1,2011,28,85,87,200
Oromia,East Hararge,Fedis,Yekatit,6,2011,69,90,68,227
Oromia,West Wellega,Gimbi Adventist Hospital,Sene,10,2011,47,84,31,162
Oromia,Assela Town,Assela Town,Teqemt,2,2010,43,13,57,113
Oromia,West Shewa,Dendi,Nehase,12,2010,58,64,4,126
Oromia,Finfine Zuria,Sululta Town,Teqemt,2,2011,26,91,32,149
Oromia,Jimma,Agaro Hospital,Nehase,12,2010,38,83,80,201
Oromia,West Shewa,Dendi,Hedar,3,2011,34,35,86,155
Oromia,West Wellega,Gimbi,Tahesas,4,2011,22,27,44,93
Oromia,West Arsi,Nensebo,Megabit,7,2011,79,62,6,147
Oromia,Dukem Town,Dukem Town,Hamle,11,2009,60,76,28,164
Oromia,Borena,Dilo,Miyazia,8,2011,5,46,99,150
Oromia,East Hararge,Chelenko Hospital,Yekatit,6,2011,21,61,70,152
Oromia,Bale,Raitu,Tir,5,2011,38,76,50,164
Oromia,Jimma Spe Town,Jimma Spe Town,Hamle,11,2009,42,78,88,208
Oromia,Arsi,Jeju,Nehase,12,2010,38,73,72,183
Oromia,North Shewa,Degem,Meskerem,1,2010,18,32,63,113
Oromia,West Hararge,Burka Dimtu,Megabit,7,2010,94,48,15,157
Oromia,Arsi,Guna,Megabit,7,2009,66,22,85,173
Oromia,Ilu Aba Bora,Algesachi,Megabit,7,2010,63,72,83,218
Oromia,Bale,Raitu,Tir,5,2010,75,21,21,117
Oromia,West Wellega,Gimbi Adventist Hospital,Ginbot,9,2010,43,29,31,103
Oromia,West Guji,Biebirsa Kojowa,Miyazia,8,2010,93,87,18,198
Oromia,Jimma,Limu Kosa,Megabit,7,2010,6,95,98,199
Oromia,West Arsi,Dodola  Hospital,Hamle,11,2010,28,17,55,100
Oromia,Jimma,Limu Hospital,Hamle,11,2009,13,49,59,121
Oromia,West Hararge,Hawi Gudina,Hamle,11,2010,98,29,41,168
Oromia,West Hararge,Tulo,Ginbot,9,2010,52,61,80,193
Oromia,South West Shewa,Tulu Bolo Hospital,Sene,10,2011,78,3,15,96
Oromia,West Arsi,Shala,Sene,10,2011,43,28,21,92
Oromia,West Wellega,Guliso,Megabit,7,2011,16,55,88,159
Oromia,Bale,Gura Dhamole,Tir,5,2011,56,95,6,157
Oromia,West Arsi,Arsi Negele Town,Meskerem,1,2011,58,35,38,131
Oromia,West Shewa,Bako Tibe,Yekatit,6,2010,29,39,60,128
Oromia,Bale,Ginir Town,Meskerem,1,2010,75,13,14,102
Oromia,Ilu Aba Bora,Bilonopa,Teqemt,2,2010,20,65,53,138
Oromia,Ilu Aba Bora,Bilonopa,Miyazia,8,2011,53,96,79,228
Oromia,Ilu Aba Bora,Metu Town,Yekatit,6,2010,3,41,5,49
Oromia,Ilu Aba Bora,Algesachi,Teqemt,2,2011,83,6,68,157
Oromia,West Shewa,Jeldu,Tir,5,2010,96,69,34,199
Oromia,West Shewa,Nono,Megabit,7,2009,17,44,13,74
Oromia,Horo Gudru Wellega,Abay Chomen,Nehase,12,2010,39,95,9,143
Oromia,West Wellega,Mene Sibu,Nehase,12,2009,6,83,32,121
Oromia,Horo Gudru Wellega,Jarte Jardga,Tahesas,4,2011,19,55,8,82
Oromia,Jimma,Agaro,Hamle,11,2010,40,70,35,145
Oromia,Sululta Town,Sululta Town,Tahesas,4,2011,92,32,34,158
Oromia,West Hararge,Habro,Tir,5,2009,49,37,52,138
Oromia,West Wellega,Nole Kaba,Nehase,12,2009,6,60,49,115
Oromia,Guji,Anna Sora,Yekatit,6,2010,26,92,51,169
Oromia,East Shewa,Adea,Megabit,7,2009,22,55,59,136
Oromia,East Wellega,Nunu Qumba,Yekatit,6,2011,94,51,70,215
Oromia,Arsi,Jeju,Yekatit,6,2011,48,97,76,221
Oromia,Arsi,Guna,Miyazia,8,2010,3,64,74,141
Oromia,East Hararge,Meta,Yekatit,6,2009,49,65,56,170
Oromia,West Shewa,Metarobi,Nehase,12,2010,37,87,91,215
Oromia,East Shewa,Bora,Tir,5,2011,18,87,95,200
Oromia,Bale,Berbere,Teqemt,2,2011,33,27,34,94
Oromia,West Hararge,Anchar,Megabit,7,2011,5,73,3,81
Oromia,North Shewa,Kuyu Hospital,Yekatit,6,2009,98,19,88,205
Oromia,Jimma,Shabe,Tir,5,2010,3,75,85,163
Oromia,West Wellega,Gimbi Adventist Hospital,Megabit,7,2010,10,8,59,77
Oromia,Bale,Dawe Qachen,Ginbot,9,2010,0,71,52,123
Oromia,Finfine Zuria,Akaki,Hamle,11,2010,84,38,12,134
Oromia,Guji,Liben,Hamle,11,2009,92,4,68,164
Oromia,East Hararge,Haromaya Rural,Miyazia,8,2011,17,65,63,145
Oromia,West Arsi,Dodola Rural,Teqemt,2,2010,69,29,87,185
Oromia,North Shewa,Yaya Gulele,Tahesas,4,2010,45,61,59,165
Oromia,Guji,Adola Town,Hamle,11,2009,37,48,31,116
Oromia,West Guji,Kercha,Megabit,7,2011,28,28,55,111
Oromia,Bale,Dinsho,Meskerem,1,2010,72,7,26,105
Oromia,East Wellega,Sibu Sire,Teqemt,2,2010,33,98,69,200
Oromia,East Wellega,Gudeyabila,Tir,5,2011,38,52,70,160
Oromia,East Wellega,Sibu Sire,Tir,5,2010,23,13,81,117
Oromia,West Guji,Hanbala,Nehase,12,2009,91,18,7,116
Oromia,Arsi,Enkelo Wabe,Miyazia,8,2010,14,27,2,43
Oromia,Guji,Wadara,Tahesas,4,2011,43,97,9,149
Oromia,Guji,Adola Reda,Hedar,3,2011,90,92,35,217
Oromia,West Wellega,Gimbi Adventist Hospital,Hedar,3,2011,70,37,64,171
Oromia,Jimma,Nono Benja,Tir,5,2010,57,95,34,186
Oromia,West Arsi,Kofele,Miyazia,8,2009,73,8,55,136
Oromia,Arsi,Bekoji Town,Teqemt,2,2010,91,18,37,146
Oromia,Arsi,Sire,Teqemt,2,2011,95,98,42,235
Oromia,Ilu Aba Bora,Hurumu,Yekatit,6,2009,70,84,96,250
Oromia,West Guji,Bule Hora,Megabit,7,2009,41,24,32,97
Oromia,East Wellega,Guto Gida,Teqemt,2,2010,58,33,60,151
Oromia,Ilu Aba Bora,Nono Sele,Sene,10,2009,49,38,64,151
Oromia,South West Shewa,Becho,Tir,5,2011,75,68,66,209
Oromia,South West Shewa,Sodo Dac'Ha,Miyazia,8,2010,86,7,63,156
Oromia,Arsi,Tena,Hedar,3,2010,7,4,18,29
Oromia,Buno Bedele,Meko,Miyazia,8,2011,90,61,38,189
Oromia,Guji,Aga Wayyu,Hedar,3,2011,2,82,85,169
Oromia,Ilu Aba Bora,Doreni,Yekatit,6,2009,8,40,57,105
Oromia,East Wellega,Limu,Tir,5,2009,61,11,97,169
Oromia,Arsi,Shenan Kolu,Ginbot,9,2011,24,75,78,177
Oromia,Arsi,Tiyo,Nehase,12,2009,17,26,71,114
Oromia,West Guji,Mkelka Soda,Tir,5,2009,94,59,74,227
Oromia,West Shewa,Gedo Hospital,Meskerem,1,2010,85,60,88,233
Oromia,West Shewa,Ilu Galan,Sene,10,2009,22,4,80,106
Oromia,West Shewa,Ginde Beret,Yekatit,6,2010,57,32,91,180
Oromia,Horo Gudru Wellega,Shambu Hospital,Sene,10,2010,4,96,76,176
Oromia,Arsi,Enkelo Wabe,Teqemt,2,2010,5,85,6,96
Oromia,West Wellega,Mene Sibu,Tir,5,2009,22,72,11,105
Oromia,Jimma,Shabe,Meskerem,1,2010,58,12,13,83
Oromia,North Shewa,Kuyu Hospital,Meskerem,1,2011,84,6,91,181
Oromia,Qeleme Wellega,Dambi Dollo,Tahesas,4,2011,44,23,26,93
Oromia,Guji,Adola Reda,Megabit,7,2011,38,8,13,59
Oromia,Arsi,Amigna,Ginbot,9,2011,54,65,38,157
Oromia,West Shewa,Jibat,Ginbot,9,2009,26,17,30,73
Oromia,West Wellega,Lalo Asabi,Tahesas,4,2011,24,62,43,129
Oromia,West Wellega,Ayira,Tahesas,4,2010,70,32,73,175
Oromia,Guji,Aga Wayyu,Hedar,3,2011,0,79,24,103
Oromia,West Shewa,Ambo,Hedar,3,2010,59,64,22,145
Oromia,Horo Gudru Wellega,Jima Geneti,Megabit,7,2009,29,83,64,176
Oromia,West Guji,Bule Hora Toun,Hamle,11,2010,73,80,20,173
Oromia,Nekemte Town,Nekemte Town,Megabit,7,2009,57,94,65,216
Oromia,East Hararge,Haromaya Rural,Sene,10,2009,68,20,51,139
Oromia,East Hararge,Haromaya Rural,Miyazia,8,2010,52,98,15,165
Oromia,Assela Town,Assela Town,Ginbot,9,2010,89,71,21,181
Oromia,Bale,Gura Dhamole,Nehase,12,2010,48,69,91,208
Oromia,Horo Gudru Wellega,Abe Dengoro,Hamle,11,2010,55,42,42,139
Oromia,West Shewa,Ambo University  Hosp,Tir,5,2011,80,46,96,222
Oromia,Arsi,Tiyo,Sene,10,2011,92,87,46,225
Oromia,Buno Bedele,Dedesa,Megabit,7,2009,30,79,4,113
Oromia,West Wellega,Qiltu Kara,Tahesas,4,2011,12,79,35,126
Oromia,North Shewa,Kimbibit,Tir,5,2011,45,38,59,142
Oromia,South West Shewa,Sodo Dac'Ha,Sene,10,2010,73,27,30,130
Oromia,Borena,Guchi,Nehase,12,2010,29,78,55,162
Oromia,Guji,Goro Dola,Meskerem,1,2010,73,15,55,143
Oromia,Qeleme Wellega,Seyo,Meskerem,1,2010,92,44,31,167
Oromia,Borena,Dhas,Hedar,3,2011,30,43,8,81
Oromia,Horo Gudru Wellega,Abe Dengoro,Teqemt,2,2010,72,29,33,134
Oromia,West Guji,Bule Hora,Sene,10,2010,16,34,10,60
Oromia,West Wellega,Lalo Asabi,Miyazia,8,2010,29,82,53,164
Oromia,Bale,Dawe Qachen,Yekatit,6,2009,23,99,86,208
Oromia,Bale,Goro,Megabit,7,2010,59,94,13,166
Oromia,Horo Gudru Wellega,Abay Chomen,Megabit,7,2011,82,15,9,106
Oromia,Buno Bedele,Bedele Zuriya,Sene,10,2009,76,29,11,116
Oromia,West Hararge,Hawi Gudina,Ginbot,9,2011,63,85,92,240
Oromia,North Shewa,Jido,Megabit,7,2010,4,52,7,63
Oromia,East Shewa,Lomme,Teqemt,2,2011,8,32,84,124
Oromia,Horo Gudru Wellega,Chomen Guduru,Tir,5,2010,0,68,71,139
Oromia,Buno Bedele,Bedele Zuriya,Teqemt,2,2010,8,2,48,58
Oromia,East Hararge,Chelenko Hospital,Tir,5,2010,6,74,58,138
Oromia,Borena,Gomole,Tahesas,4,2010,12,59,78,149
Oromia,West Guji,Hanbala,Sene,10,2009,59,35,0,94
Oromia,Bale,Robe Town,Sene,10,2009,18,25,98,141
Oromia,Bale,Ginir,Sene,10,2011,90,22,71,183
Oromia,East Hararge,Aweday Town,Megabit,7,2009,56,54,93,203
Oromia,Buno Bedele,Boricha,Ginbot,9,2011,1,8,46,55
Oromia,West Arsi,Hebal Arsi,Tir,5,2010,84,67,80,231
Oromia,Borena,Dilo,Tahesas,4,2011,13,81,84,178
Oromia,Buno Bedele,Bedele Town,Nehase,12,2010,72,85,84,241
Oromia,West Hararge,Gelemso Hospital,Tahesas,4,2011,63,3,52,118
Oromia,South West Shewa,Ameya Hospital,Teqemt,2,2011,92,11,44,147
Oromia,Borena,Moyale Hospital,Megabit,7,2010,79,44,34,157
Oromia,North Shewa,Were Jarso,Megabit,7,2010,45,15,43,103
Oromia,Borena,Yabelo Hospital,Hamle,11,2009,66,56,4,126
Oromia,Jimma,Setema,Tahesas,4,2010,30,6,55,91
Oromia,Qeleme Wellega,Sedan Chanka,Teqemt,2,2010,84,0,27,111
Oromia,Buno Bedele,Diga,Hamle,11,2010,79,86,32,197
Oromia,West Arsi,Kokosa,Teqemt,2,2011,64,7,33,104
Oromia,Guji,Adola Town,Hedar,3,2010,66,66,5,137
Oromia,West Arsi,Dodola Town,Meskerem,1,2010,71,86,10,167
Oromia,South West Shewa,Tulu Bolo Hospital,Meskerem,1,2010,66,21,10,97
Oromia,Borena,Dilo,Meskerem,1,2011,8,44,21,73
Oromia,East Wellega,Guto Gida,Megabit,7,2010,7,13,42,62
Oromia,West Wellega,Begi Hospital,Sene,10,2011,65,87,9,161
Oromia,Borena,Guchi,Hedar,3,2011,23,12,17,52
Oromia,West Hararge,Daro Lebu,Teqemt,2,2010,25,18,46,89
Oromia,Arsi,Aseko,Nehase,12,2009,24,16,92,132
Oromia,West Wellega,Genji,Tahesas,4,2011,73,54,4,131
Oromia,North Shewa,Dera,Ginbot,9,2011,61,2,55,118
Oromia,South West Shewa,Becho,Hedar,3,2010,95,55,72,222
Oromia,Ambo Town,Ambo Town,Meskerem,1,2011,65,39,47,151
Oromia,West Guji,Bule Hora,Hedar,3,2010,6,94,57,157
Oromia,West Guji,Kercha,Megabit,7,2011,97,93,29,219
Oromia,West Hararge,Daro Lebu,Yekatit,6,2009,34,48,71,153
Oromia,East Hararge,Bedeno,Hedar,3,2010,6,0,65,71
Oromia,Bale,Ginir Town,Nehase,12,2010,2,2,88,92
Oromia,Borena,Yabelo,Ginbot,9,2011,25,1,49,75
Oromia,West Shewa,Inchini Hospital,Tahesas,4,2010,38,26,2,66
Oromia,Dukem Town,Dukem Town,Sene,10,2009,23,73,14,110
Oromia,West Shewa,Ambo,Miyazia,8,2009,68,43,83,194
Oromia,West Shewa,Jeldu,Meskerem,1,2011,86,71,84,241
Oromia,Jimma,Agaro Hospital,Tahesas,4,2011,30,30,18,78
Oromia,Finfine Zuria,Sandefa,Sene,10,2009,69,1,82,152
Oromia,East Hararge,Chelenko Hospital,Tir,5,2010,3,4,87,94
Oromia,West Shewa,Abuna Gindeberet,Miyazia,8,2010,56,41,56,153
Oromia,Buno Bedele,Meko,Yekatit,6,2009,70,2,84,156
Oromia,East Shewa,Bora,Tir,5,2009,77,16,57,150
Oromia,West Shewa,Gojo Hospital,Yekatit,6,2011,52,10,43,105
Oromia,West Arsi,Shashemene Rural,Ginbot,9,2010,21,29,23,73
Oromia,West Guji,Hanbala,Hamle,11,2010,69,8,80,157
Oromia,Qeleme Wellega,Sedan Chanka,Tir,5,2011,42,53,74,169
Oromia,Arsi,Deksis,Megabit,7,2011,61,35,23,119
Oromia,Ilu Aba Bora,Bilonopa,Ginbot,9,2009,79,39,37,155
Oromia,West Wellega,Nejo Hospital,Hedar,3,2011,54,11,80,145
Oromia,Buno Bedele,Dedesa,Nehase,12,2010,32,38,91,161
Oromia,Horo Gudru Wellega,Shambu Town,Megabit,7,2011,34,85,90,209
Oromia,Bale,Arena Buluq,Tahesas,4,2011,24,63,10,97
Oromia,Adama Special Town,Adama Town,Meskerem,1,2011,68,31,65,164
Oromia,West Wellega,Kundala,Yekatit,6,2009,19,13,85,117
Oromia,Ilu Aba Bora,Nono Sele,Ginbot,9,2009,1,86,36,123
Oromia,West Guji,Kercha Hospital,Sene,10,2011,2,22,51,75
Oromia,Arsi,Dodota,Megabit,7,2011,22,25,48,95
Oromia,Robe Town,Robe Town,Ginbot,9,2010,8,17,47,72
Oromia,East Hararge,Goro Gutu,Hamle,11,2010,37,28,72,137
Oromia,East Shewa,Fentale,Sene,10,2010,67,26,60,153
Oromia,Borena,Dhas,Megabit,7,2011,43,56,7,106
Oromia,Borena,Dhas,Hamle,11,2009,33,12,75,120
Oromia,North Shewa,Fiche Hospital,Yekatit,6,2009,76,51,24,151
Oromia,Jimma,Limu Hospital,Megabit,7,2010,14,7,55,76
Oromia,Ilu Aba Bora,Didu,Nehase,12,2010,87,4,33,124
Oromia,Modjo Town,Modjo Town,Tahesas,4,2010,57,33,37,127
Oromia,Ilu Aba Bora,Yayu,Teqemt,2,2010,65,7,8,80
Oromia,West Shewa,Ilu Galan,Megabit,7,2009,69,46,42,157
Oromia,North Shewa,Kimbibit,Miyazia,8,2009,69,64,1,134
Oromia,North Shewa,Girar Jarso,Ginbot,9,2011,6,50,15,71
Oromia,West Arsi,Wondo,Ginbot,9,2011,18,37,31,86
Oromia,West Wellega,Kundala,Tahesas,4,2011,88,90,5,183
Oromia,Borena,Gomole,Teqemt,2,2010,95,72,15,182
Oromia,West Shewa,Codi,Miyazia,8,2011,41,60,98,199
Oromia,West Shewa,Gedo Hospital,Sene,10,2009,87,26,91,204
Oromia,Borena,Dubluk,Meskerem,1,2010,57,59,37,153
Oromia,West Wellega,Boji Cheqorsa,Hamle,11,2010,91,79,0,170
Oromia,Ilu Aba Bora,Nono Sele,Tahesas,4,2011,84,1,0,85
Oromia,Horo Gudru Wellega,Chomen Guduru,Hedar,3,2011,49,4,44,97
Oromia,Qeleme Wellega,Yemalogi Wolel,Meskerem,1,2011,55,33,52,140
Oromia,Ilu Aba Bora,Yayu,Sene,10,2011,20,56,37,113
Oromia,Guji,Negele Town,Hedar,3,2010,48,53,12,113
Oromia,West Guji,Bule Hora,Ginbot,9,2011,69,73,78,220
Oromia,Buno Bedele,Dapho Hana,Megabit,7,2011,83,86,68,237
Oromia,Ilu Aba Bora,Nono Sele,Meskerem,1,2010,69,57,64,190
Oromia,Buno Bedele,Bedele Zuriya,Hedar,3,2010,13,45,83,141
Oromia,Ilu Aba Bora,Ale,Sene,10,2009,50,40,54,144
Oromia,East Hararge,Goro Gutu,Miyazia,8,2010,68,76,11,155
Oromia,Arsi,Shenan Kolu,Hedar,3,2010,91,99,16,206
Oromia,Arsi,Tena,Meskerem,1,2011,70,85,61,216
Oromia,Finfine Zuria,Mullo,Hedar,3,2011,39,47,16,102
Oromia,Jimma Spe Town,Jimma Spe Town,Nehase,12,2010,79,40,56,175
Oromia,East Wellega,Gudeyabila,Megabit,7,2009,76,18,9,103
Oromia,West Wellega,Nejo Rural,Miyazia,8,2011,13,74,60,147
Oromia,East Shewa,Olanciti Hospital,Sene,10,2010,72,10,68,150
Oromia,South West Shewa,Ameya Hospital,Sene,10,2011,33,52,26,111
Oromia,West Shewa,Dano,Megabit,7,2011,48,21,94,163
Oromia,Qeleme Wellega,Hawa Gelan,Miyazia,8,2009,29,47,55,131
Oromia,East Wellega,Gudeyabila,Hamle,11,2010,62,88,2,152
Oromia,Bale,Dawe Qachen,Yekatit,6,2011,50,85,1,136
Oromia,West Shewa,Bako Tibe,Tir,5,2009,95,25,67,187
Oromia,East Wellega,Sasiga,Meskerem,1,2010,71,25,33,129
Oromia,West Hararge,Oda Bultum,Tir,5,2010,41,17,3,61
Oromia,East Shewa,Batu,Yekatit,6,2011,56,67,63,186
Oromia,Arsi,Deksis,Nehase,12,2009,69,29,66,164
Oromia,West Shewa,Abuna Gindeberet,Ginbot,9,2009,53,74,61,188
Oromia,West Guji,Hanbala,Tahesas,4,2010,61,33,68,162
Oromia,West Shewa,Jibat,Megabit,7,2010,31,62,63,156
Oromia,Guji,Hambela Wamena,Tir,5,2011,24,66,20,110
Oromia,Bale,Goro,Miyazia,8,2009,89,68,1,158
Oromia,Arsi,Jeju,Sene,10,2009,78,22,33,133
Oromia,Borena,Yabelo Rural,Ginbot,9,2010,60,97,4,161
Oromia,Jimma,Agaro,Sene,10,2010,81,9,65,155
Oromia,Ilu Aba Bora,Bure,Sene,10,2009,82,35,9,126
Oromia,Bale,Seweyna,Miyazia,8,2010,22,78,19,119
Oromia,West Wellega,Gimbi Rural,Nehase,12,2009,4,35,78,117
Oromia,East Wellega,Sibu Sire,Teqemt,2,2010,50,56,5,111
Oromia,Qeleme Wellega,Dale Sedi,Tahesas,4,2011,60,72,53,185
Oromia,East Wellega,Wayu Tuqa,Teqemt,2,2011,65,36,73,174
Oromia,Buno Bedele,Chora,Hedar,3,2010,64,96,36,196
Oromia,Bale,Dawe Serar,Yekatit,6,2011,52,34,74,160
Oromia,Ilu Aba Bora,Halu,Nehase,12,2009,20,79,93,192
Oromia,East Hararge,Fedis,Nehase,12,2009,83,90,54,227
Oromia,Borena,Gomole,Sene,10,2011,9,27,12,48
Oromia,West Shewa,Tibe Kutaye,Megabit,7,2009,23,50,10,83
Oromia,East Hararge,Deder,Tir,5,2009,87,64,10,161
Oromia,West Wellega,Seyo Nole,Tir,5,2010,24,1,43,68
Oromia,Guji,Uraga,Tahesas,4,2010,86,87,40,213
Oromia,Bale,Dinsho,Miyazia,8,2009,98,41,21,160
Oromia,Qeleme Wellega,Dambi Dolo Hospital,Megabit,7,2009,61,53,0,114
Oromia,West Shewa,Adea Berga,Meskerem,1,2011,25,70,78,173
Oromia,West Wellega,Lalo Asabi,Miyazia,8,2011,15,53,11,79
Oromia,Jimma,Seka Chekorsa,Ginbot,9,2011,77,20,69,166
Oromia,Borena,Moyale Hospital,Megabit,7,2009,25,12,11,48
Oromia,East Hararge,Jarso,Sene,10,2009,57,54,85,196
Oromia,West Arsi,Hebal Arsi,Sene,10,2011,91,25,62,178
Oromia,North Shewa,Jido,Miyazia,8,2011,31,89,57,177
Oromia,West Hararge,Chiro Zuriya,Tir,5,2009,51,57,34,142
Oromia,East Hararge,Meyu Muleke,Teqemt,2,2011,30,96,72,198
Oromia,East Hararge,Fedis,Yekatit,6,2009,3,65,74,142
Oromia,West Shewa,Meta Waliqite,Tir,5,2011,11,51,52,114
Oromia,Jimma,Seka Chekorsa,Megabit,7,2009,22,11,67,100
Oromia,Qeleme Wellega,Dambi Dollo,Ginbot,9,2011,40,69,72,181
Oromia,West Arsi,Kokosa  Hospital,Miyazia,8,2011,61,85,79,225
Oromia,East Wellega,Boneya Bushe,Miyazia,8,2009,48,83,87,218
Oromia,Buno Bedele,Bedele Town,Yekatit,6,2010,52,45,8,105
Oromia,East Shewa,Liben,Ginbot,9,2011,19,80,55,154
Oromia,Finfine Zuria,Berreh,Megabit,7,2010,92,36,97,225
Oromia,East Hararge,Bedeno,Hedar,3,2011,29,74,72,175
Oromia,West Shewa,Ambo,Nehase,12,2009,98,78,86,262
Oromia,North Shewa,Hidabu Abote,Sene,10,2010,29,96,20,145
Oromia,West Arsi,Bishan Guracha Town,Ginbot,9,2010,36,88,62,186
Oromia,Borena,Meyo,Hedar,3,2011,26,74,51,151
Oromia,West Wellega,Ayira,Miyazia,8,2011,29,68,74,171
Oromia,East Hararge,Jarso,Yekatit,6,2009,98,76,78,252
Oromia,Jimma,Nono Benja,Ginbot,9,2010,2,33,64,99
Oromia,East Hararge,Kersa Eh,Miyazia,8,2010,41,59,80,180
Oromia,Jimma,Limu Seka,Tahesas,4,2011,7,29,79,115
Oromia,West Arsi,Kofele,Tahesas,4,2010,68,11,91,170
Oromia,West Hararge,Habro,Ginbot,9,2010,36,7,84,127
Oromia,Arsi,Robe,Hamle,11,2010,10,76,60,146
Oromia,West Shewa,Elifata,Ginbot,9,2011,77,32,0,109
Oromia,South West Shewa,Dawo,Hamle,11,2010,66,85,38,189
Oromia,East Hararge,Kersa Eh,Nehase,12,2009,59,81,23,163
Oromia,North Shewa,Dera Hospital,Yekatit,6,2010,38,9,16,63
Oromia,East Hararge,Babile Woreda,Ginbot,9,2011,66,59,73,198
Oromia,Qeleme Wellega,Seyo,Ginbot,9,2009,56,34,90,180
Oromia,West Shewa,Ejerie,Meskerem,1,2011,47,98,45,190
Oromia,Horo Gudru Wellega,Shambu Town,Nehase,12,2010,56,15,56,127
Oromia,West Wellega,Lata Sibu,Ginbot,9,2011,43,70,43,156
Oromia,Finfine Zuria,Mullo,Ginbot,9,2011,54,60,14,128
Oromia,Borena,Dubluk,Miyazia,8,2009,13,32,86,131
Oromia,Bale,Meda Welabu,Sene,10,2010,39,22,77,138
Oromia,East Shewa,Batu,Nehase,12,2010,32,10,57,99
Oromia,North Shewa,Kuyu Hospital,Ginbot,9,2011,50,70,33,153
Oromia,West Shewa,Ilu Galan,Yekatit,6,2011,29,35,35,99
Oromia,East Wellega,Nunu Qumba,Meskerem,1,2010,78,43,91,212
Oromia,West Hararge,Tulo,Hamle,11,2009,54,69,98,221
Oromia,West Arsi,Dodola Rural,Nehase,12,2009,59,15,21,95
Oromia,North Shewa,Wuchale,Miyazia,8,2009,76,31,43,150
Oromia,West Wellega,Nejo Rural,Tahesas,4,2011,52,10,57,119
Oromia,East Wellega,Guto Gida,Hedar,3,2010,91,11,3,105
Oromia,East Wellega,Wayu Tuqa,Tir,5,2011,1,13,64,78
Oromia,East Wellega,Wama Hagelo,Teqemt,2,2010,72,51,69,192
Oromia,Qeleme Wellega,Hawa Gelan Hosp,Ginbot,9,2011,83,52,44,179
Oromia,East Wellega,Jimma Arjo,Hedar,3,2011,6,59,2,67
Oromia,East Wellega,Gida Ayana,Hedar,3,2011,94,56,4,154
Oromia,South West Shewa,Bantu  Hospital,Sene,10,2010,74,75,47,196
Oromia,South West Shewa,Kersana Malima,Hedar,3,2010,73,76,64,213
Oromia,Guji,Dima,Meskerem,1,2011,29,90,56,175
Oromia,Bale,Seweyna,Ginbot,9,2011,89,63,40,192
Oromia,West Wellega,Ayira,Tir,5,2011,10,8,60,78
Oromia,West Wellega,Lalo Asabi,Nehase,12,2010,42,39,82,163
Oromia,Guji,Odo Shakiso,Megabit,7,2010,75,78,41,194
Oromia,South West Shewa,Woliso Rural,Nehase,12,2009,97,7,77,181
Oromia,Bale,Raitu,Ginbot,9,2011,49,87,2,138
Oromia,Arsi,Jeju,Nehase,12,2009,40,13,60,113
Oromia,South West Shewa,Ameya,Sene,10,2010,17,86,33,136
Oromia,East Wellega,Wama Hagelo,Ginbot,9,2009,30,11,76,117
Oromia,East Shewa,Batu,Megabit,7,2009,69,90,16,175
Oromia,Holeta Town,Holeta Town,Yekatit,6,2011,26,90,70,186
Oromia,North Shewa,Were Jarso,Hamle,11,2010,61,69,80,210
Oromia,Arsi,Limuna Bilbilo,Sene,10,2009,84,80,7,171
Oromia,East Wellega,Diga,Hedar,3,2010,28,30,87,145
Oromia,Arsi,Limuna Bilbilo,Megabit,7,2009,59,44,8,111
Oromia,South West Shewa,Woliso Town,Ginbot,9,2009,30,6,38,74
Oromia,West Guji,Abaya,Sene,10,2011,57,49,55,161
Oromia,West Shewa,Gindeberet Hospital,Teqemt,2,2010,73,63,5,141
Oromia,Arsi,Robe,Meskerem,1,2010,4,14,11,29
Oromia,Jimma,B/Tolyi,Miyazia,8,2010,28,35,76,139
Oromia,East Wellega,Guto Gida,Meskerem,1,2011,34,10,81,125
Oromia,Arsi,Amigna,Tir,5,2009,44,46,14,104
Oromia,Borena,Dilo,Nehase,12,2010,56,96,53,205
Oromia,East Shewa,Adea,Sene,10,2010,78,71,32,181
Oromia,West Wellega,Homa,Tir,5,2011,52,86,70,208
Oromia,Bale,Agarfa,Megabit,7,2009,31,16,48,95
Oromia,Robe Town,Robe Town,Meskerem,1,2011,92,6,69,167
Oromia,Jimma,Gomma,Tir,5,2009,25,29,14,68
Oromia,East Hararge,Meyu Muleke,Miyazia,8,2011,84,7,38,129
Oromia,West Guji,Mkelka Soda,Ginbot,9,2011,3,41,20,64
Oromia,West Hararge,Habro,Hamle,11,2009,22,92,36,150
Oromia,East Shewa,Liben,Miyazia,8,2009,42,72,42,156
Oromia,Arsi,Digeluna Tijo,Ginbot,9,2010,9,48,43,100
Oromia,Lege Dadi Lege Tafo Town,Lege Dadi Lege Tafo Town,Megabit,7,2010,94,52,11,157
Oromia,Buno Bedele,Bedele Town,Ginbot,9,2010,9,61,46,116
Oromia,West Guji,Kercha,Yekatit,6,2011,50,97,87,234
Oromia,West Arsi,Gambo Hospital,Sene,10,2009,52,47,42,141
Oromia,Borena,Meyo,Yekatit,6,2011,6,61,14,81
Oromia,Guji,Dima,Megabit,7,2009,84,55,45,184
Oromia,Bale,Dawe Qachen,Ginbot,9,2009,54,38,78,170
Oromia,Guji,Liben,Ginbot,9,2010,10,52,86,148
Oromia,West Arsi,Kofele,Hedar,3,2010,18,46,72,136
Oromia,Qeleme Wellega,Sedan Chanka,Nehase,12,2010,25,22,65,112
Oromia,Ilu Aba Bora,Didu,Nehase,12,2010,97,31,79,207
Oromia,East Hararge,Melka Belo,Teqemt,2,2010,26,76,35,137
Oromia,West Wellega,Homa,Yekatit,6,2010,79,56,37,172
Oromia,Ambo Town,Ambo Town,Yekatit,6,2010,76,82,36,194
Oromia,West Shewa,Ambo Hospital,Sene,10,2011,18,20,62,100
Oromia,East Wellega,Gobu Seyo,Megabit,7,2011,71,4,43,118
Oromia,East Wellega,Jimma Arjo,Yekatit,6,2010,63,53,40,156
Oromia,Bale,Seweyna,Hamle,11,2010,49,52,13,114
Oromia,Bale,Raitu,Ginbot,9,2009,43,86,53,182
Oromia,East Shewa,Adami Tulu Jido Kombolcha,Teqemt,2,2011,47,50,51,148
Oromia,South West Shewa,Ilu,Teqemt,2,2011,4,21,3,28
Oromia,North Shewa,Wuchale,Megabit,7,2009,12,40,15,67
Oromia,Dukem Town,Dukem Town,Hamle,11,2010,97,53,43,193
Oromia,Bale,Gura Dhamole,Nehase,12,2009,46,50,19,115
Oromia,East Wellega,Limu,Ginbot,9,2009,34,26,25,85
Oromia,East Wellega,Sasiga,Nehase,12,2010,98,70,87,255
Oromia,West Arsi,Kore,Tir,5,2009,61,61,18,140
Oromia,West Shewa,Ejerie,Meskerem,1,2011,15,20,8,43
Oromia,Arsi,Deksis,Hedar,3,2010,24,97,93,214
Oromia,Jimma,B/Tolyi,Hamle,11,2010,4,18,42,64
Oromia,East Hararge,Babile,Tir,5,2009,36,24,41,101
Oromia,Jimma,Dedo,Yekatit,6,2011,28,27,48,103
Oromia,Qeleme Wellega,Anfilo,Megabit,7,2010,81,27,20,128
Oromia,West Wellega,Nole Kaba,Ginbot,9,2011,86,42,48,176
Oromia,Guji,Saba Boru,Ginbot,9,2011,71,56,76,203
Oromia,Arsi,Jeju,Sene,10,2010,43,18,97,158
Oromia,East Wellega,Nunu Qumba,Miyazia,8,2011,80,90,30,200
Oromia,Jimma,Limu Hospital,Miyazia,8,2010,52,29,0,81
Oromia,Ilu Aba Bora,Nono Sele,Hamle,11,2010,63,59,92,214
Oromia,East Hararge,Chinakesen,Miyazia,8,2011,98,19,62,179
Oromia,West Wellega,Mendi Town,Tir,5,2011,46,47,14,107
Oromia,East Shewa,Adea,Miyazia,8,2011,70,56,16,142
Oromia,West Arsi,Kokosa  Hospital,Meskerem,1,2011,81,83,15,179
Oromia,West Wellega,Haru,Tir,5,2010,94,83,81,258
Oromia,Buno Bedele,Diga,Miyazia,8,2011,99,78,28,205
Oromia,Borena,Meyo,Hedar,3,2011,8,42,68,118
Oromia,Qeleme Wellega,Hawa Gelan Hosp,Hedar,3,2011,86,52,63,201
Oromia,Jimma,Guma,Sene,10,2011,12,60,39,111
Oromia,Horo Gudru Wellega,Shambu Town,Tir,5,2009,30,49,73,152
Oromia,Buno Bedele,Bedele Zuriya,Miyazia,8,2011,5,29,95,129
Oromia,West Arsi,Hebal Arsi,Miyazia,8,2010,3,16,19,38
Oromia,West Wellega,Mendi Town,Tir,5,2010,3,42,61,106
Oromia,North Shewa,Aleiltu,Tir,5,2010,39,7,6,52
Oromia,West Guji,Kercha,Tir,5,2010,3,32,41,76
Oromia,Jimma,Setema,Sene,10,2010,41,77,43,161
Oromia,West Wellega,Mene Sibu,Teqemt,2,2011,72,59,26,157
Oromia,East Shewa,Adami Tulu Jido Kombolcha,Sene,10,2010,16,63,44,123
Oromia,Qeleme Wellega,Jimma Horo,Miyazia,8,2009,6,7,3,16
Oromia,Nekemte Town,Nekemte Town,Teqemt,2,2011,39,35,68,142
Oromia,Buno Bedele,Chewaqa,Sene,10,2009,51,63,30,144
Oromia,Guji,Aga Wayyu,Meskerem,1,2011,86,38,36,160
Oromia,West Shewa,Ginde Beret,Tahesas,4,2010,59,66,80,205
Oromia,Ilu Aba Bora,Doreni,Sene,10,2009,97,50,13,160
Oromia,East Wellega,Ebantu,Ginbot,9,2011,27,60,31,118
Oromia,Bale,Delo Mena,Tahesas,4,2010,88,54,18,160
Oromia,Guji,Adola Hospital,Ginbot,9,2009,94,23,7,124
Oromia,Borena,Dire,Ginbot,9,2010,4,56,49,109
Oromia,Finfine Zuria,Berreh,Sene,10,2011,37,94,23,154
Oromia,West Hararge,Chiro Zuriya,Sene,10,2010,13,63,60,136
Oromia,Borena,Teltele,Tir,5,2011,40,51,81,172
Oromia,West Shewa,Jeldu,Miyazia,8,2011,39,35,36,110
Oromia,East Hararge,Goro Muti,Miyazia,8,2009,47,39,64,150
Oromia,Finfine Zuria,Sululta Town,Meskerem,1,2011,40,83,89,212
Oromia,Horo Gudru Wellega,Jarte Jardga,Megabit,7,2010,70,36,98,204
Oromia,West Shewa,Gindeberet Hospital,Sene,10,2011,99,9,41,149
Oromia,Arsi,Shirka,Meskerem,1,2010,1,87,71,159
Oromia,East Wellega,Jimma Arjo,Miyazia,8,2009,73,26,81,180
Oromia,West Arsi,Kokosa  Hospital,Tir,5,2011,90,28,50,168
Oromia,West Shewa,Abuna Gindeberet,Hedar,3,2010,11,81,35,127
Oromia,South West Shewa,Bantu  Hospital,Tahesas,4,2011,63,8,24,95
Oromia,West Wellega,Gimbi,Teqemt,2,2010,40,36,60,136
Oromia,Jimma Spe Town,Jimma Spe Town,Ginbot,9,2009,14,11,68,93
Oromia,Jimma,Sigmo,Miyazia,8,2010,71,14,97,182
Oromia,West Shewa,Bako Tibe,Sene,10,2010,70,48,31,149
Oromia,West Arsi,Kokosa  Hospital,Megabit,7,2010,69,84,85,238
Oromia,East Hararge,Deder Town,Meskerem,1,2011,47,45,0,92
Oromia,West Hararge,Meiso,Ginbot,9,2009,15,14,29,58
Oromia,East Hararge,Kombolicha,Megabit,7,2011,58,57,42,157
Oromia,East Shewa,Batu,Yekatit,6,2009,85,50,6,141
Oromia,West Hararge,Chiro Zuriya,Miyazia,8,2009,37,9,25,71
Oromia,West Hararge,Burka Dimtu,Hedar,3,2011,99,71,38,208
Oromia,West Hararge,Gemechis,Tir,5,2010,0,42,95,137
Oromia,West Shewa,Adea Berga,Meskerem,1,2011,45,47,83,175
Oromia,West Wellega,Boji Cheqorsa,Meskerem,1,2011,12,64,31,107
Oromia,West Wellega,Mendi Town,Hamle,11,2010,9,88,39,136
Oromia,South West Shewa,Ameya,Ginbot,9,2010,54,97,63,214
Oromia,East Hararge,Gursum,Yekatit,6,2009,95,63,10,168
Oromia,West Shewa,Jibat,Tahesas,4,2011,61,35,36,132
Oromia,West Wellega,Gimbi,Yekatit,6,2010,29,90,70,189
Oromia,West Guji,Biebirsa Kojowa,Megabit,7,2009,54,29,70,153
Oromia,Qeleme Wellega,Anfilo,Tahesas,4,2011,25,67,23,115
Oromia,West Shewa,Midakegni,Hamle,11,2009,75,39,49,163
Oromia,Bale,Agarfa,Meskerem,1,2010,79,21,89,189
Oromia,West Shewa,Bako Tibe,Tahesas,4,2010,64,54,53,171
Oromia,Guji,Negele Town,Hedar,3,2010,90,43,38,171
Oromia,Guji,Shakiso Town,Megabit,7,2011,90,26,27,143
Oromia,East Wellega,Ebantu,Megabit,7,2011,89,73,82,244
Oromia,Bale,Meda Welabu,Hamle,11,2009,19,48,63,130
Oromia,West Wellega,Qiltu Kara,Ginbot,9,2009,96,57,8,161
Oromia,West Wellega,Boji Dermeji,Tir,5,2011,40,7,63,110
Oromia,Ilu Aba Bora,Metu Rural,Megabit,7,2011,25,86,33,144
Oromia,West Wellega,Mene Sibu,Ginbot,9,2011,9,32,10,51
Oromia,Qeleme Wellega,Gidami,Yekatit,6,2009,98,71,94,263
Oromia,Buno Bedele,Bedele Town,Miyazia,8,2010,36,1,93,130
Oromia,North Shewa,Debre Libanos,Tir,5,2009,84,55,36,175
Oromia,West Shewa,Nono,Nehase,12,2009,77,98,39,214
Oromia,West Wellega,Qiltu Kara,Sene,10,2009,82,28,92,202
Oromia,East Shewa,Boset,Yekatit,6,2009,68,50,38,156
Oromia,West Wellega,Genji,Ginbot,9,2009,91,94,37,222
Oromia,West Shewa,Jibat,Ginbot,9,2010,76,90,99,265
Oromia,Jimma,Mana,Megabit,7,2010,72,41,39,152
Oromia,Arsi,Jeju,Teqemt,2,2010,25,46,58,129
Oromia,Horo Gudru Wellega,Shambu Town,Sene,10,2011,17,76,83,176
Oromia,West Shewa,Dano,Megabit,7,2011,14,65,12,91
Oromia,East Wellega,Gobu Seyo,Nehase,12,2010,51,85,18,154
Oromia,Borena,Moyale,Miyazia,8,2011,42,34,4,80
Oromia,Buno Bedele,Diga,Meskerem,1,2010,45,5,17,67
Oromia,Arsi,Tiyo,Ginbot,9,2010,22,57,38,117
Oromia,Arsi,Robe,Miyazia,8,2009,1,77,90,168
Oromia,West Shewa,Chelia,Tir,5,2009,64,11,25,100
Oromia,East Shewa,Lomme,Teqemt,2,2011,51,72,97,220
Oromia,Guji,Saba Boru,Ginbot,9,2011,93,78,33,204
Oromia,East Hararge,Meta,Tir,5,2011,58,86,78,222
Oromia,Arsi,Zeway Dugda,Megabit,7,2011,72,96,57,225
Oromia,Finfine Zuria,Walmera,Hedar,3,2011,3,7,61,71
Oromia,Borena,Teltele,Miyazia,8,2011,61,43,99,203
Oromia,West Arsi,Wondo,Megabit,7,2009,94,96,50,240
Oromia,Bale,Goba,Megabit,7,2010,80,79,27,186
Oromia,East Hararge,Garemuleta Hospital,Hedar,3,2010,11,26,32,69
Oromia,Guji,Wadara,Megabit,7,2009,45,48,8,101
Oromia,East Hararge,Bedeno,Teqemt,2,2010,66,93,18,177
Oromia,West Shewa,Gojo Hospital,Hamle,11,2009,61,20,52,133
Oromia,West Shewa,Jibat,Sene,10,2009,7,27,60,94
Oromia,West Shewa,Liban Jawi,Nehase,12,2009,78,92,73,243
Oromia,West Guji,Bule Hora Toun,Yekatit,6,2010,47,5,93,145
Oromia,Guji,Wadara,Hedar,3,2010,8,37,10,55
Oromia,South West Shewa,Seden Sodo,Megabit,7,2011,42,97,75,214
Oromia,West Wellega,Gimbi Public  Hospital,Ginbot,9,2009,14,11,99,124
Oromia,Horo Gudru Wellega,Jima Rare,Sene,10,2011,41,36,94,171
Oromia,East Hararge,Gole Oda,Megabit,7,2009,80,66,34,180
Oromia,Guji,Dima,Hedar,3,2011,91,54,36,181
Oromia,Qeleme Wellega,Dambi Dolo Hospital,Teqemt,2,2011,68,74,92,234
Oromia,East Shewa,Adea,Megabit,7,2009,29,21,81,131
Oromia,Guji,Negele Hospital,Tahesas,4,2010,98,46,80,224
Oromia,Jimma,Omonada,Hedar,3,2010,85,72,15,172
Oromia,South West Shewa,Seden Sodo,Ginbot,9,2010,76,11,56,143
Oromia,South West Shewa,Ameya,Sene,10,2010,5,6,7,18
Oromia,West Hararge,Chiro Town,Sene,10,2010,99,91,13,203
Oromia,Arsi,Digeluna Tijo,Tir,5,2009,78,36,60,174
Oromia,East Hararge,Aweday Town,Hedar,3,2010,27,18,5,50
Oromia,Bale,Goro,Megabit,7,2009,0,47,25,72
Oromia,West Hararge,West Harerge	Gumbi Bordede,Miyazia,8,2009,78,78,11,167
Oromia,Guji,Wadara,Hedar,3,2010,87,97,97,281
Oromia,Jimma,Omo Nada Hospital,Tir,5,2011,45,78,75,198
Oromia,Bale,Ginir,Teqemt,2,2011,59,33,36,128
Oromia,East Hararge,Haromaya Hospital,Miyazia,8,2009,53,41,3,97
Oromia,Horo Gudru Wellega,Hababo Guduru,Megabit,7,2009,13,47,72,132
Oromia,East Shewa,Lomme,Tir,5,2011,37,41,0,78
Oromia,West Arsi,Kore,Sene,10,2010,23,3,90,116
Oromia,West Shewa,Tikur Enchini,Meskerem,1,2011,20,23,42,85
Oromia,Borena,Arero,Sene,10,2009,34,79,91,204
Oromia,West Arsi,Arsi Negele Rural,Miyazia,8,2009,21,54,75,150
Oromia,South West Shewa,Tulu Bolo Hospital,Nehase,12,2010,22,51,47,120
Oromia,Finfine Zuria,Berreh,Teqemt,2,2011,4,32,16,52
Oromia,Bale,Goba,Sene,10,2009,6,11,39,56
Oromia,Guji,Odo Shakiso,Nehase,12,2010,97,75,49,221
Oromia,Arsi,Bekoji Town,Ginbot,9,2010,14,89,79,182
Oromia,Buno Bedele,Bedele Town,Ginbot,9,2010,17,48,1,66
Oromia,Qeleme Wellega,Hawa Gelan Hosp,Tir,5,2011,31,49,83,163
Oromia,West Shewa,Tikur Enchini,Ginbot,9,2011,13,62,29,104
Oromia,Guji,Wadara,Hamle,11,2009,18,25,22,65
Oromia,East Hararge,Midega Tole,Hedar,3,2010,13,30,54,97
Oromia,Assela Town,Assela Town,Yekatit,6,2011,63,64,72,199
Oromia,Buno Bedele,Meko,Megabit,7,2011,81,89,57,227
Oromia,Qeleme Wellega,Yemalogi Wolel,Tir,5,2009,58,86,77,221
Oromia,West Wellega,Gimbi Rural,Sene,10,2009,90,92,55,237
Oromia,East Wellega,Nunu Qumba,Tir,5,2009,89,45,33,167
Oromia,Qeleme Wellega,Gidami Hosp,Tahesas,4,2011,81,37,88,206
Oromia,West Guji,Kercha Hospital,Hedar,3,2010,74,69,28,171
Oromia,West Wellega,Nejo Hospital,Sene,10,2009,66,67,62,195
Oromia,Arsi,Robe,Megabit,7,2010,21,65,86,172
Oromia,Bale,Gura Dhamole,Nehase,12,2009,16,31,17,64
Oromia,Borena,Teltele,Megabit,7,2009,68,46,61,175
Oromia,West Arsi,Gambo Hospital,Megabit,7,2009,84,63,69,216
Oromia,East Wellega,Wama Hagelo,Tir,5,2010,90,56,42,188
Oromia,Arsi,Tiyo,Tahesas,4,2010,35,52,17,104
Oromia,Ilu Aba Bora,Bilonopa,Miyazia,8,2010,74,39,43,156
Oromia,Borena,Dhas,Miyazia,8,2011,97,44,70,211
Oromia,Borena,Dire,Tir,5,2011,19,46,67,132
Oromia,West Arsi,Shala,Hedar,3,2010,90,24,14,128
Oromia,South West Shewa,Goro,Sene,10,2009,81,64,73,218
Oromia,Ilu Aba Bora,Metu Town,Tahesas,4,2010,48,56,3,107
Oromia,Horo Gudru Wellega,Jarte Jardga,Nehase,12,2010,12,83,65,160
Oromia,West Hararge,Gemechis,Ginbot,9,2010,67,86,43,196
Oromia,Bale,Seweyna,Yekatit,6,2009,41,7,69,117
Oromia,Borena,Yabelo Hospital,Hedar,3,2010,29,72,87,188
Oromia,East Wellega,Nunu Qumba,Tahesas,4,2011,30,75,49,154
Oromia,West Wellega,Kundala,Miyazia,8,2011,76,44,80,200
Oromia,West Shewa,Tikur Enchini,Yekatit,6,2010,95,1,21,117
Oromia,Borena,Yabelo,Nehase,12,2010,13,14,61,88
Oromia,Arsi,Zeway Dugda,Megabit,7,2009,24,73,14,111
Oromia,West Wellega,Nejo Rural,Tahesas,4,2011,60,15,53,128
Oromia,East Hararge,Haromaya Hospital,Megabit,7,2010,25,96,53,174
Oromia,Bale,Goba,Megabit,7,2010,98,49,35,182
Oromia,East Shewa,Gimbichu,Teqemt,2,2010,64,76,27,167
Oromia,West Guji,Biebirsa Kojowa,Ginbot,9,2009,8,50,64,122
Oromia,Qeleme Wellega,Gidami,Ginbot,9,2010,4,70,68,142
Oromia,Borena,Dubluk,Teqemt,2,2011,43,78,7,128
Oromia,East Hararge,Kumbi,Megabit,7,2009,62,11,30,103
Oromia,Finfine Zuria,Walmera,Hedar,3,2011,85,84,15,184
Oromia,West Shewa,Gedo Hospital,Ginbot,9,2009,51,7,98,156
Oromia,West Shewa,Gojo Hospital,Sene,10,2011,31,52,25,108
Oromia,Arsi,Aseko,Hedar,3,2011,59,83,68,210
Oromia,North Shewa,Jido,Ginbot,9,2011,43,24,52,119
Oromia,East Hararge,Deder Town,Megabit,7,2011,11,84,99,194
Oromia,South West Shewa,Goro,Miyazia,8,2011,43,47,12,102
Oromia,North Shewa,Kimbibit,Meskerem,1,2011,56,66,41,163
Oromia,Buno Bedele,Meko,Teqemt,2,2010,43,62,15,120
Oromia,Ilu Aba Bora,Becho,Nehase,12,2009,96,65,56,217
Oromia,West Shewa,Meta Waliqite,Megabit,7,2010,15,91,2,108
Oromia,Woliso Town,Woliso Town,Sene,10,2010,90,82,98,270
Oromia,Ilu Aba Bora,Doreni,Sene,10,2009,11,40,59,110
Oromia,West Hararge,Guba Qoricha,Nehase,12,2010,63,14,22,99
Oromia,Finfine Zuria,Mullo,Miyazia,8,2010,10,54,80,144
Oromia,West Wellega,Mendi Hospital,Hamle,11,2010,46,21,36,103
Oromia,West Guji,Dugda Dawa,Yekatit,6,2009,43,73,14,130
Oromia,Arsi,Seru,Ginbot,9,2010,23,73,78,174
Oromia,Arsi,Sire,Tahesas,4,2011,54,42,83,179
Oromia,Horo Gudru Wellega,Amuru,Teqemt,2,2011,50,8,18,76
Oromia,West Shewa,Guder Hosp,Teqemt,2,2011,37,35,15,87
Oromia,West Shewa,Ambo,Tahesas,4,2011,58,27,67,152
Oromia,Bale,Dawe Qachen,Tir,5,2010,17,56,34,107
Oromia,Guji,Dima,Hedar,3,2011,32,24,0,56
Oromia,Bishoftu Town,Bishoftu Town,Ginbot,9,2009,27,78,44,149
Oromia,Buno Bedele,Bedele Town,Sene,10,2009,50,64,8,122
Oromia,West Shewa,Bako Hospital,Nehase,12,2010,5,42,6,53
Oromia,North Shewa,Were Jarso,Nehase,12,2010,36,17,5,58
Oromia,Horo Gudru Wellega,Jarte Jardga,Tahesas,4,2010,41,41,56,138
Oromia,Arsi,Sude,Meskerem,1,2010,14,70,82,166
Oromia,Jimma,Limu Seka,Ginbot,9,2010,28,48,67,143
Oromia,Arsi,Limuna Bilbilo,Tir,5,2011,56,58,8,122
Oromia,Guji,Aga Wayyu,Hedar,3,2011,71,13,49,133
Oromia,West Wellega,Mendi Hospital,Ginbot,9,2011,55,22,42,119
Oromia,East Hararge,Fedis,Hedar,3,2011,97,89,94,280
Oromia,West Shewa,Tibe Kutaye,Ginbot,9,2010,19,53,96,168
Oromia,East Hararge,Goro Gutu,Ginbot,9,2010,45,60,11,116
Oromia,Jimma,Agaro,Ginbot,9,2010,59,27,55,141
Oromia,West Wellega,Nejo Rural,Megabit,7,2009,99,51,82,232
Oromia,West Arsi,Gambo Hospital,Miyazia,8,2011,54,81,58,193
Oromia,East Hararge,Meyu Muleke,Nehase,12,2010,1,68,62,131
Oromia,Bale,Gasera,Hedar,3,2010,16,40,85,141
Oromia,Arsi,Amigna,Ginbot,9,2011,54,56,33,143
Oromia,North Shewa,Kuyu Hospital,Sene,10,2009,63,12,73,148
Oromia,South West Shewa,Ameya Hospital,Tahesas,4,2011,43,77,83,203
Oromia,East Shewa,Adea,Megabit,7,2011,78,18,40,136
Oromia,North Shewa,Fiche Hospital,Nehase,12,2010,78,71,11,160
Oromia,East Shewa,Liben,Hamle,11,2009,27,77,13,117
Oromia,Gelan Town,Gelan Town,Yekatit,6,2010,7,99,80,186
Oromia,Bale,Gololcha,Megabit,7,2011,51,45,45,141
Oromia,Bale,Berbere,Tir,5,2010,76,24,2,102
Oromia,West Shewa,Adea Berga,Hedar,3,2010,65,72,42,179
Oromia,Guji,Adola Town,Tir,5,2011,26,92,28,146
Oromia,Qeleme Wellega,Gidami,Megabit,7,2011,80,36,6,122
Oromia,East Wellega,Haro Limu,Yekatit,6,2010,80,29,45,154
Oromia,North Shewa,Wuchale,Teqemt,2,2010,14,10,23,47
Oromia,West Shewa,Tikur Enchini,Tir,5,2009,29,16,0,45
Oromia,West Arsi,Dodola Rural,Teqemt,2,2010,9,20,77,106
Oromia,West Hararge,Anchar,Tir,5,2011,83,6,27,116
Oromia,Bale,Ginir Town,Nehase,12,2010,36,19,86,141
Oromia,Guji,Adola Reda,Meskerem,1,2010,54,84,98,236
Oromia,North Shewa,Wuchale,Miyazia,8,2011,44,64,27,135
Oromia,Qeleme Wellega,Anfilo,Miyazia,8,2010,97,39,82,218
Oromia,West Hararge,West Harerge	Gumbi Bordede,Tir,5,2009,38,57,5,100
Oromia,East Shewa,Fentale,Hedar,3,2010,82,13,12,107
Oromia,Qeleme Wellega,Laloqile,Tir,5,2010,47,77,66,190
Oromia,Jimma,Sigmo,Tir,5,2011,83,36,51,170
Oromia,West Shewa,Ginde Beret,Sene,10,2011,49,28,47,124
Oromia,Guji,Uraga,Hedar,3,2010,1,95,25,121
Oromia,East Hararge,Chinakesen,Nehase,12,2010,54,17,39,110
Oromia,West Guji,Suro Barguda,Hedar,3,2011,3,70,55,128
Oromia,Borena,Guchi,Tahesas,4,2011,21,99,80,200
Oromia,East Hararge,Babile,Yekatit,6,2010,88,2,62,152
Oromia,Borena,Gomole,Tir,5,2009,34,95,61,190
Oromia,Jimma,Setema Hospital,Hamle,11,2010,84,80,30,194
Oromia,Bale,Ginir Town,Hedar,3,2011,48,17,1,66
Oromia,West Arsi,Gambo Hospital,Tir,5,2011,49,61,30,140
Oromia,Ilu Aba Bora,Becho,Teqemt,2,2010,55,80,27,162
Oromia,Borena,Wachile,Ginbot,9,2010,17,75,6,98
Oromia,West Guji,Bule Hora,Nehase,12,2009,79,39,48,166
Oromia,Finfine Zuria,Akaki,Miyazia,8,2011,84,61,41,186
Oromia,Guji,Aga Wayyu,Tir,5,2009,83,52,3,138
Oromia,West Hararge,Habro,Sene,10,2011,18,20,28,66
Oromia,Arsi,Bekoji Town,Hamle,11,2009,6,59,48,113
Oromia,East Shewa,Olanciti Hospital,Yekatit,6,2009,65,51,86,202
Oromia,West Shewa,Ejersa Lafo,Miyazia,8,2011,2,6,12,20
Oromia,Arsi,Seru,Ginbot,9,2009,63,7,85,155
Oromia,Finfine Zuria,Mullo,Ginbot,9,2010,17,31,83,131
Oromia,Woliso Town,Woliso Town,Ginbot,9,2011,44,96,22,162
Oromia,West Hararge,Oda Bultum,Nehase,12,2009,39,52,82,173
Oromia,North Shewa,Debre Libanos,Hedar,3,2010,59,79,44,182
Oromia,Guji,Adola Hospital,Nehase,12,2009,83,14,90,187
Oromia,West Guji,Biebirsa Kojowa,Sene,10,2009,86,60,37,183
Oromia,Jimma,Gera,Sene,10,2009,9,76,2,87
Oromia,Ilu Aba Bora,Bure,Hedar,3,2011,91,54,31,176
Oromia,Ilu Aba Bora,Metu Town,Megabit,7,2009,21,42,26,89
Oromia,West Guji,Bule Hora Toun,Ginbot,9,2009,46,85,56,187
Oromia,West Shewa,Ambo,Sene,10,2009,13,74,74,161
Oromia,East Hararge,Aweday Town,Nehase,12,2009,32,96,38,166
Oromia,South West Shewa,Tulu Bolo Hospital,Tir,5,2009,68,93,67,228
Oromia,West Hararge,Daro Lebu,Tahesas,4,2010,1,79,68,148
Oromia,East Wellega,Limu,Megabit,7,2009,58,8,67,133
Oromia,West Hararge,Bedesa Town,Hamle,11,2010,75,47,10,132
Oromia,Bale,Seweyna,Megabit,7,2009,12,11,82,105
Oromia,Horo Gudru Wellega,Abay Chomen,Ginbot,9,2009,34,41,66,141
Oromia,West Shewa,Meta Waliqite,Ginbot,9,2009,64,27,52,143
Oromia,Jimma,Omonada,Miyazia,8,2010,64,46,25,135
Oromia,Guji,Liben,Megabit,7,2009,51,8,81,140
Oromia,West Arsi,Gambo Hospital,Nehase,12,2010,88,10,3,101
Oromia,East Shewa,Adea,Teqemt,2,2010,61,37,16,114
Oromia,West Hararge,Tulo,Tir,5,2011,99,79,84,262
Oromia,Bale,Gololcha,Sene,10,2009,8,38,76,122
Oromia,Arsi,Munesa,Ginbot,9,2009,31,14,21,66
Oromia,Bale,Ginir Town,Yekatit,6,2010,9,56,32,97
Oromia,East Hararge,Goro Muti,Sene,10,2010,50,15,83,148
Oromia,East Hararge,Babile,Hamle,11,2009,59,35,34,128
Oromia,Arsi,Gololcha,Sene,10,2010,95,28,69,192
Oromia,North Shewa,Debre Libanos,Yekatit,6,2009,86,77,96,259
Oromia,Borena,Yabelo Rural,Tir,5,2010,64,90,90,244
Oromia,Borena,Teltele,Meskerem,1,2010,0,32,78,110
Oromia,West Arsi,Kokosa  Hospital,Nehase,12,2010,25,28,2,55
Oromia,West Guji,Kercha,Miyazia,8,2011,94,55,9,158
Oromia,West Shewa,Adea Berga,Tahesas,4,2010,69,74,88,231
Oromia,North Shewa,Dera Hospital,Hedar,3,2011,72,67,0,139
Oromia,Arsi,Seru,Yekatit,6,2010,47,66,36,149
Oromia,Ilu Aba Bora,Didu,Sene,10,2010,63,77,64,204
Oromia,Guji,Hambela Wamena,Nehase,12,2009,96,17,67,180
Oromia,East Hararge,Meyu Muleke,Nehase,12,2009,60,23,36,119
Oromia,West Shewa,Bako Hospital,Meskerem,1,2011,47,18,57,122
Oromia,Horo Gudru Wellega,Shambu Hospital,Hedar,3,2011,83,93,23,199
Oromia,Guji,Adola Town,Hamle,11,2010,98,22,62,182
Oromia,South West Shewa,Ameya Hospital,Hedar,3,2011,82,15,22,119
Oromia,Guji,Gumi Eldallo,Miyazia,8,2009,49,0,10,59
Oromia,Holeta Town,Holeta Town,Ginbot,9,2011,0,41,8,49
Oromia,West Arsi,Wondo,Nehase,12,2010,51,64,58,173
Oromia,West Arsi,Kokosa  Hospital,Sene,10,2010,36,73,96,205
Oromia,Qeleme Wellega,Dale Sedi,Sene,10,2009,86,52,80,218
Oromia,Borena,Yabelo Rural,Tir,5,2011,67,15,76,158
Oromia,West Shewa,Dano,Yekatit,6,2009,91,89,27,207
Oromia,Qeleme Wellega,Dale Sedi,Yekatit,6,2010,53,68,90,211
Oromia,Bale,Legehida,Hedar,3,2011,59,3,65,127
Oromia,Bishoftu Town,Bishoftu Town,Yekatit,6,2009,7,18,17,42
Oromia,Bale,Arena Buluq,Ginbot,9,2011,77,28,33,138
Oromia,Borena,Yabelo Hospital,Tir,5,2011,79,23,48,150
Oromia,Guji,Adola Reda,Tahesas,4,2010,36,52,10,98
Oromia,East Wellega,Limu,Hamle,11,2009,18,77,46,141
Oromia,East Shewa,Adami Tulu Jido Kombolcha,Megabit,7,2010,24,33,24,81
Oromia,Guji,Wadara,Tir,5,2011,29,80,50,159
Oromia,East Wellega,Sibu Sire,Megabit,7,2010,47,55,68,170
Oromia,West Hararge,Hawi Gudina,Sene,10,2011,76,12,99,187
Oromia,West Arsi,Gedeb Asasa,Teqemt,2,2010,93,54,44,191
Oromia,Dukem Town,Dukem Town,Ginbot,9,2011,19,39,34,92
Oromia,Borena,Teltele,Sene,10,2010,26,27,90,143
Oromia,Finfine Zuria,Walmera,Tir,5,2009,69,9,99,177
Oromia,East Shewa,Olanciti Hospital,Teqemt,2,2010,69,25,72,166
Oromia,East Shewa,Adama,Nehase,12,2010,92,27,21,140
Oromia,West Shewa,Tibe Kutaye,Ginbot,9,2010,98,83,3,184
Oromia,West Shewa,Ambo Town,Nehase,12,2009,1,77,22,100
Oromia,West Wellega,Mendi Town,Yekatit,6,2011,49,83,18,150
Oromia,Lege Dadi Lege Tafo Town,Lege Dadi Lege Tafo Town,Sene,10,2009,90,55,86,231
Oromia,East Wellega,Kiremu,Tahesas,4,2011,9,5,97,111
Oromia,Bale,Goba,Nehase,12,2010,63,53,49,165
Oromia,Jimma,Gomma,Teqemt,2,2011,70,45,89,204
Oromia,West Arsi,Kofele,Tir,5,2010,1,75,44,120
Oromia,Sululta Town,Sululta Town,Tir,5,2011,17,14,34,65
Oromia,North Shewa,Fiche Hospital,Yekatit,6,2011,82,57,5,144
Oromia,Guji,Adola Reda,Hedar,3,2011,71,36,85,192
Oromia,North Shewa,Fiche Hospital,Megabit,7,2010,59,25,92,176
Oromia,Horo Gudru Wellega,Shambu Town,Megabit,7,2009,79,99,43,221
Oromia,West Shewa,Tibe Kutaye,Nehase,12,2010,26,5,6,37
Oromia,West Shewa,Ejersa Lafo,Tir,5,2011,73,92,7,172
Oromia,Arsi,Munesa,Ginbot,9,2011,63,40,45,148
Oromia,West Guji,Mkelka Soda,Sene,10,2009,24,2,38,64
Oromia,East Wellega,Limu,Megabit,7,2009,53,80,80,213
Oromia,Bale,Sinana,Sene,10,2009,56,27,52,135
Oromia,South West Shewa,Ilu,Miyazia,8,2010,50,48,34,132
Oromia,West Arsi,Kore,Sene,10,2011,66,36,97,199
Oromia,East Hararge,Girawa,Sene,10,2010,35,48,66,149
Oromia,East Hararge,Deder Hospital,Nehase,12,2010,16,53,68,137
Oromia,Bale,Dinsho,Tir,5,2011,15,35,65,115
Oromia,Jimma,B/Tolyi,Ginbot,9,2010,48,92,92,232
Oromia,South West Shewa,Ameya,Ginbot,9,2011,63,5,52,120
Oromia,West Hararge,Bedesa Town,Ginbot,9,2011,95,50,20,165
Oromia,Qeleme Wellega,Yemalogi Wolel,Teqemt,2,2010,77,42,20,139
Oromia,North Shewa,Dera Hospital,Hedar,3,2010,78,42,30,150
Oromia,Buno Bedele,Bedele Zuriya,Tahesas,4,2010,96,49,10,155
Oromia,West Shewa,Dano,Hamle,11,2009,96,90,71,257
Oromia,West Wellega,Nejo Hospital,Sene,10,2010,15,35,87,137
Oromia,Guji,Bore,Tir,5,2009,39,67,11,117
Oromia,West Wellega,Mendi Hospital,Meskerem,1,2010,14,97,77,188
Oromia,Bale,Seweyna,Hamle,11,2010,50,13,8,71
Oromia,Ambo Town,Ambo Town,Ginbot,9,2010,57,97,69,223
Oromia,Bale,Goro,Hedar,3,2011,32,67,58,157
Oromia,Guji,Wadara,Nehase,12,2009,26,10,93,129
Oromia,North Shewa,Dera Hospital,Tir,5,2011,19,30,70,119
Oromia,Guji,Girja,Miyazia,8,2010,4,3,92,99
Oromia,Guji,Negele Town,Ginbot,9,2011,13,27,59,99
Oromia,Bale,Goba Town,Nehase,12,2009,53,50,7,110
Oromia,Gelan Town,Gelan Town,Hedar,3,2010,37,12,45,94
Oromia,West Wellega,Kundala,Hedar,3,2011,67,65,74,206
Oromia,West Wellega,Genji,Tir,5,2009,7,26,96,129
Oromia,Bale,Agarfa,Nehase,12,2010,83,27,42,152
Oromia,Horo Gudru Wellega,Gudru,Yekatit,6,2010,4,75,81,160
Oromia,Bale,Gura Dhamole,Teqemt,2,2010,90,19,47,156
Oromia,West Hararge,Oda Bultum,Meskerem,1,2010,84,62,27,173
Oromia,Bale,Arena Buluq,Sene,10,2009,63,84,29,176
Oromia,Borena,Meyo,Miyazia,8,2010,15,29,8,52
Oromia,Buno Bedele,Bedele Town,Megabit,7,2011,33,95,43,171
Oromia,Arsi,Bekoji Town,Megabit,7,2011,84,75,97,256
Oromia,Qeleme Wellega,Laloqile,Hedar,3,2011,75,45,17,137
Oromia,West Wellega,Qiltu Kara,Megabit,7,2010,2,32,94,128
Oromia,Bale,Raitu,Nehase,12,2010,64,96,23,183
Oromia,West Guji,Bule Hora,Hamle,11,2009,35,40,17,92
Oromia,West Shewa,Nono,Ginbot,9,2011,58,78,13,149
Oromia,Finfine Zuria,Mullo,Tir,5,2011,28,45,97,170
Oromia,Borena,Moyale Hospital,Yekatit,6,2011,30,45,26,101
Oromia,East Wellega,Diga,Nehase,12,2010,51,63,59,173
Oromia,Sululta Town,Sululta Town,Tir,5,2011,15,47,28,90
Oromia,East Wellega,Ebantu,Nehase,12,2009,57,9,12,78
Oromia,Borena,Teltele,Yekatit,6,2010,15,58,45,118
Oromia,East Shewa,Bora,Miyazia,8,2011,93,92,30,215
Oromia,East Hararge,Haromaya Town,Megabit,7,2009,58,54,40,152
Oromia,Qeleme Wellega,Yemalogi Wolel,Megabit,7,2010,79,5,36,120
Oromia,East Hararge,Fedis,Tir,5,2011,92,43,45,180
Oromia,Arsi,Tiyo,Meskerem,1,2011,7,55,25,87
Oromia,Gelan Town,Gelan Town,Tir,5,2010,70,66,61,197
Oromia,West Guji,Bule Hora Toun,Yekatit,6,2009,67,72,45,184
Oromia,Lege Dadi Lege Tafo Town,Lege Dadi Lege Tafo Town,Megabit,7,2011,33,25,16,74
Oromia,Buno Bedele,Bedele Town,Sene,10,2009,96,77,51,224
Oromia,West Wellega,Mene Sibu,Ginbot,9,2010,63,45,13,121
Oromia,West Arsi,Kokosa  Hospital,Megabit,7,2011,95,87,56,238
Oromia,Jimma,Nono Benja,Sene,10,2009,90,81,3,174
Oromia,East Shewa,Boset,Yekatit,6,2011,88,16,10,114
Oromia,Finfine Zuria,Berreh,Hamle,11,2010,42,61,46,149
Oromia,East Hararge,Midega Tole,Ginbot,9,2011,21,85,88,194
Oromia,Bale,Legehida,Ginbot,9,2011,17,6,32,55
Oromia,Ilu Aba Bora,Doreni,Hedar,3,2011,58,11,71,140
Oromia,East Wellega,Gida Ayana,Megabit,7,2009,60,43,30,133
Oromia,Buno Bedele,Bedele Town,Megabit,7,2011,3,83,46,132
Oromia,Jimma,Omonada,Ginbot,9,2010,11,58,9,78
Oromia,South West Shewa,Kersana Malima,Megabit,7,2011,18,21,68,107
Oromia,East Wellega,Leqa Dulecha,Meskerem,1,2011,66,91,83,240
Oromia,West Wellega,Gimbi,Tir,5,2010,60,6,12,78
Oromia,East Wellega,Gida Ayana,Ginbot,9,2009,45,45,54,144
Oromia,East Hararge,Aweday Town,Sene,10,2010,37,99,68,204
Oromia,Arsi,Bekoji Town,Miyazia,8,2009,29,17,16,62
Oromia,Gelan Town,Gelan Town,Tir,5,2010,42,57,2,101
Oromia,West Wellega,Mendi Town,Tahesas,4,2010,56,91,42,189
Oromia,West Wellega,Lata Sibu,Nehase,12,2010,53,94,69,216
Oromia,Arsi,Tiyo,Hamle,11,2010,56,95,63,214
Oromia,Guji,Negele Town,Meskerem,1,2010,81,51,78,210
Oromia,East Shewa,Gimbichu,Ginbot,9,2010,45,58,93,196
Oromia,West Hararge,Mesela,Ginbot,9,2011,9,76,8,93
Oromia,South West Shewa,St.Luke Hospital,Megabit,7,2009,35,98,18,151
Oromia,East Shewa,Adami Tulu Jido Kombolcha,Miyazia,8,2010,10,33,35,78
Oromia,West Guji,Suro Barguda,Hedar,3,2011,26,61,26,113
Oromia,Bale,Legehida,Meskerem,1,2010,39,71,19,129
Oromia,West Wellega,Seyo Nole,Ginbot,9,2010,95,71,95,261
Oromia,North Shewa,Girar Jarso,Hedar,3,2011,49,22,53,124
Oromia,East Wellega,Sasiga,Hamle,11,2010,38,38,88,164
Oromia,North Shewa,Muke Turi Hospital,Sene,10,2011,57,80,41,178
Oromia,West Shewa,Liban Jawi,Nehase,12,2010,35,43,96,174
Oromia,Nekemte Town,Nekemte Town,Yekatit,6,2009,69,12,86,167
Oromia,South West Shewa,Dawo,Nehase,12,2010,90,15,92,197
Oromia,Finfine Zuria,Akaki,Ginbot,9,2010,31,59,30,120
Oromia,East Hararge,Haromaya Rural,Tahesas,4,2011,63,34,57,154
Oromia,West Hararge,Doba,Ginbot,9,2010,10,50,77,137
Oromia,Finfine Zuria,Walmera,Teqemt,2,2011,73,67,78,218
Oromia,West Hararge,Guba Qoricha,Yekatit,6,2011,37,49,28,114
Oromia,West Arsi,Nensebo,Ginbot,9,2010,10,57,64,131
Oromia,Bale,Goro,Yekatit,6,2009,23,95,56,174
Oromia,Borena,Dubluk,Nehase,12,2009,76,79,15,170
Oromia,Buno Bedele,Dhidesa Hospital,Sene,10,2011,12,35,71,118
Oromia,East Hararge,Meta,Ginbot,9,2010,91,42,67,200
Oromia,Finfine Zuria,Walmera,Sene,10,2011,1,82,47,130
Oromia,West Wellega,Jarso,Miyazia,8,2011,23,34,25,82
Oromia,Borena,Yabelo,Teqemt,2,2011,15,34,68,117
Oromia,Borena,Dhas,Hedar,3,2010,24,34,3,61
Oromia,Arsi,Robe,Tir,5,2011,74,38,18,130
Oromia,East Wellega,Limu,Miyazia,8,2009,51,2,31,84
Oromia,East Shewa,Dugda,Ginbot,9,2011,54,48,51,153
Oromia,West Hararge,Burka Dimtu,Yekatit,6,2010,85,71,82,238
Oromia,Qeleme Wellega,Anfilo,Nehase,12,2009,9,74,68,151
Oromia,East Hararge,Goro Gutu,Yekatit,6,2010,82,67,0,149
Oromia,East Hararge,Deder Hospital,Ginbot,9,2010,54,9,18,81
Oromia,Qeleme Wellega,Seyo,Tir,5,2010,12,6,81,99
Oromia,Lege Dadi Lege Tafo Town,Lege Dadi Lege Tafo Town,Megabit,7,2009,36,73,29,138
Oromia,North Shewa,Fiche Hospital,Tahesas,4,2011,27,71,53,151
Oromia,Ilu Aba Bora,Nono Sele,Tir,5,2011,64,15,84,163
Oromia,West Hararge,Oda Bultum,Sene,10,2010,51,40,3,94
Oromia,Ilu Aba Bora,Doreni,Yekatit,6,2010,10,92,60,162
Oromia,Horo Gudru Wellega,Jarte Jardga,Sene,10,2009,2,79,46,127
Oromia,Horo Gudru Wellega,Shambu Town,Miyazia,8,2011,90,16,85,191
Oromia,East Shewa,Adami Tulu Jido Kombolcha,Tahesas,4,2011,87,4,17,108
Oromia,East Wellega,Leqa Dulecha,Sene,10,2010,56,44,10,110
Oromia,Arsi,Bale Gesgara,Megabit,7,2009,31,26,52,109
Oromia,Borena,Guchi,Tahesas,4,2011,62,53,26,141
Oromia,Lege Dadi Lege Tafo Town,Lege Dadi Lege Tafo Town,Sene,10,2011,77,62,35,174
Oromia,Bale,Gasera,Megabit,7,2010,65,27,98,190
Oromia,Ilu Aba Bora,Nono Sele,Megabit,7,2010,50,0,36,86
Oromia,Assela Town,Assela Town,Tahesas,4,2011,77,59,80,216
Oromia,West Hararge,Bedesa Town,Teqemt,2,2011,95,18,14,127
Oromia,West Shewa,Nono,Megabit,7,2010,83,82,39,204
Oromia,Guji,Wadara,Megabit,7,2010,5,94,97,196
Oromia,West Hararge,Daro Lebu,Tir,5,2009,75,15,22,112
Oromia,North Shewa,Kuyu,Meskerem,1,2010,37,80,73,190
Oromia,West Arsi,Kokosa,Miyazia,8,2011,3,79,47,129
Oromia,Borena,Teltele,Tir,5,2010,12,94,51,157
Oromia,West Shewa,Liban Jawi,Yekatit,6,2010,9,79,7,95
Oromia,West Hararge,Gelemso Hospital,Tahesas,4,2010,61,72,80,213
Oromia,West Wellega,Nejo Rural,Tir,5,2009,23,98,88,209
Oromia,West Shewa,Inchini Hospital,Tir,5,2011,75,41,93,209
Oromia,Ilu Aba Bora,Ale,Ginbot,9,2010,15,54,79,148
Oromia,Arsi,Jeju,Tahesas,4,2011,25,12,81,118
Oromia,North Shewa,Kimbibit,Nehase,12,2009,41,27,8,76
Oromia,North Shewa,Degem,Ginbot,9,2009,86,53,68,207
Oromia,Horo Gudru Wellega,Jarte Jardga,Tahesas,4,2011,47,74,86,207
Oromia,West Shewa,Bako Tibe,Hamle,11,2010,95,73,13,181
Oromia,East Wellega,Wama Hagelo,Megabit,7,2010,99,73,18,190
Oromia,South West Shewa,Tole,Megabit,7,2010,95,64,95,254
Oromia,West Shewa,Tibe Kutaye,Sene,10,2010,4,57,64,125
Oromia,East Hararge,Haromaya Hospital,Miyazia,8,2011,17,60,8,85
Oromia,West Hararge,Chiro Hospital,Tahesas,4,2010,78,25,61,164
Oromia,Bale,Arena Buluq,Nehase,12,2009,25,27,9,61
Oromia,West Arsi,Dodola Rural,Miyazia,8,2011,12,44,56,112
Oromia,Jimma,Agaro,Miyazia,8,2011,82,66,38,186
Oromia,Arsi,Ludehetosa,Megabit,7,2010,82,36,48,166
Oromia,West Shewa,Tikur Enchini,Megabit,7,2009,37,23,51,111
Oromia,Buno Bedele,Bedele Town,Hedar,3,2011,4,74,13,91
Oromia,Arsi,Jeju,Teqemt,2,2011,59,17,95,171
Oromia,Arsi,Gololcha,Ginbot,9,2011,54,74,87,215
Oromia,North Shewa,Were Jarso,Tir,5,2011,62,69,32,163
Oromia,East Hararge,Kombolicha,Yekatit,6,2010,10,10,37,57
Oromia,West Guji,Bule Hora Toun,Hedar,3,2011,68,12,96,176
Oromia,Buno Bedele,Chora,Hedar,3,2010,58,3,86,147
Oromia,Jimma,Sekoru,Miyazia,8,2010,43,19,38,100
Oromia,Guji,Shakiso Town,Hamle,11,2010,72,42,70,184
Oromia,West Wellega,Lalo Asabi,Megabit,7,2009,87,18,85,190
Oromia,West Shewa,Ejerie,Sene,10,2011,74,1,79,154
Oromia,West Guji,Bule Hora Toun,Tahesas,4,2010,54,42,18,114
Oromia,Guji,Bore,Sene,10,2010,23,33,68,124
Oromia,North Shewa,Yaya Gulele,Tir,5,2009,3,89,58,150
Oromia,South West Shewa,Tulu Bolo Hospital,Hedar,3,2010,72,2,36,110
Oromia,South West Shewa,St.Luke Hospital,Hedar,3,2010,39,53,57,149
Oromia,East Wellega,Sibu Sire,Hamle,11,2010,46,8,56,110
Oromia,Ilu Aba Bora,Yayu,Tir,5,2010,18,61,76,155
Oromia,Jimma,Tiro Afeta,Megabit,7,2010,14,31,40,85
Oromia,West Wellega,Mene Sibu,Megabit,7,2010,3,47,66,116
Oromia,Borena,Wachile,Ginbot,9,2010,99,11,97,207
Oromia,West Shewa,Chelia,Nehase,12,2009,91,28,79,198
Oromia,Bale,Goba Town,Miyazia,8,2009,27,74,14,115
Oromia,West Hararge,Doba,Ginbot,9,2010,42,21,18,81
Oromia,Jimma,Limu Seka,Megabit,7,2009,67,57,20,144
Oromia,East Wellega,Guto Gida,Hamle,11,2009,12,90,10,112
Oromia,Assela Town,Assela Town,Tir,5,2011,44,75,97,216
Oromia,Guji,Goro Dola,Tir,5,2010,80,87,24,191
Oromia,North Shewa,Kimbibit,Hedar,3,2010,12,96,68,176
Oromia,West Wellega,Begi,Tir,5,2010,65,3,24,92
Oromia,West Shewa,Chelia,Hamle,11,2009,40,93,93,226
Oromia,West Shewa,Gedo Hospital,Nehase,12,2010,84,24,97,205
Oromia,South West Shewa,Kersana Malima,Ginbot,9,2009,87,88,62,237
Oromia,Arsi,Shirka,Hedar,3,2010,0,70,55,125
Oromia,Borena,Gomole,Megabit,7,2009,28,87,4,119
Oromia,Guji,Goro Dola,Tir,5,2011,66,65,61,192
Oromia,Finfine Zuria,Walmera,Nehase,12,2009,1,67,24,92
Oromia,Qeleme Wellega,Hawa Gelan,Meskerem,1,2010,56,54,32,142
Oromia,Arsi,Bale Gesgara,Megabit,7,2010,78,76,57,211
Oromia,Qeleme Wellega,Gidami,Hedar,3,2011,59,96,5,160
Oromia,Horo Gudru Wellega,Jima Geneti,Tir,5,2011,1,6,71,78
Oromia,Burayu Town,Burayu Town,Tir,5,2011,63,25,67,155
Oromia,Qeleme Wellega,Gawo Qebe,Tir,5,2011,24,99,63,186
Oromia,Bale,Meda Welabu,Tir,5,2011,20,46,71,137
Oromia,Bale,Goro,Ginbot,9,2011,87,58,89,234
Oromia,Guji,Bore,Meskerem,1,2011,16,89,59,164
Oromia,West Arsi,Nensebo,Megabit,7,2009,75,77,10,162
Oromia,Arsi,Chole,Ginbot,9,2009,32,63,37,132
Oromia,Horo Gudru Wellega,Shambu Town,Ginbot,9,2009,3,88,48,139
Oromia,Guji,Girja,Nehase,12,2009,43,53,69,165
Oromia,West Hararge,Guba Qoricha,Meskerem,1,2010,0,23,10,33
Oromia,Jimma,Tiro Afeta,Yekatit,6,2010,24,16,75,115
Oromia,Qeleme Wellega,Hawa Gelan,Yekatit,6,2009,88,68,20,176
Oromia,Arsi,Aseko,Tir,5,2011,25,72,33,130
Oromia,Jimma,Mana,Nehase,12,2010,83,4,97,184
Oromia,Sebeta Town,Sebeta Town,Miyazia,8,2010,26,80,8,114
Oromia,Bale,Dinsho,Megabit,7,2009,90,10,76,176
Oromia,East Wellega,Gobu Seyo,Nehase,12,2009,70,22,51,143
Oromia,East Hararge,Deder Hospital,Megabit,7,2010,5,23,63,91
Oromia,Borena,Yabelo Hospital,Tir,5,2010,95,59,19,173
Oromia,West Shewa,Nono,Hamle,11,2009,1,52,73,126
Oromia,East Shewa,Lomme,Megabit,7,2010,36,30,93,159
Oromia,West Wellega,Nejo Hospital,Megabit,7,2011,76,94,43,213
Oromia,North Shewa,Jido,Tir,5,2010,18,99,94,211
Oromia,South West Shewa,St.Luke Hospital,Miyazia,8,2010,81,98,96,275
Oromia,Borena,Gomole,Megabit,7,2011,16,45,15,76
Oromia,West Arsi,Kofele,Hedar,3,2010,30,65,34,129
Oromia,Horo Gudru Wellega,Horo,Megabit,7,2009,51,30,63,144
Oromia,Guji,Odo Shakiso,Sene,10,2009,51,91,45,187
Oromia,Horo Gudru Wellega,Jima Geneti,Tahesas,4,2011,91,6,93,190
Oromia,Jimma,Shabe,Sene,10,2010,25,42,71,138
Oromia,Jimma,Kersa,Hamle,11,2010,66,14,18,98
Oromia,West Shewa,Tibe Kutaye,Megabit,7,2009,7,22,77,106
Oromia,South West Shewa,Seden Sodo,Tir,5,2009,97,66,61,224
Oromia,West Arsi,Loke Hada Hospital,Hamle,11,2010,81,81,69,231
Oromia,West Hararge,Habro,Tir,5,2009,0,89,37,126
Oromia,Qeleme Wellega,Anfilo,Tahesas,4,2010,83,29,37,149
Oromia,West Hararge,Gemechis,Hamle,11,2009,15,95,20,130
Oromia,Buno Bedele,Gechi,Yekatit,6,2011,3,91,72,166
Oromia,Jimma,Nono Benja,Nehase,12,2009,87,68,9,164
Oromia,West Wellega,Gimbi Rural,Sene,10,2009,49,24,73,146
Oromia,Arsi,Sire,Sene,10,2011,16,78,77,171
Oromia,Ilu Aba Bora,Yayu,Ginbot,9,2011,59,86,64,209
Oromia,Borena,Arero,Tahesas,4,2011,70,85,34,189
Oromia,Arsi,Munesa,Hedar,3,2010,49,86,77,212
Oromia,Jimma,Omonada,Sene,10,2009,70,17,75,162
Oromia,West Shewa,Tibe Kutaye,Meskerem,1,2010,62,44,52,158
Oromia,North Shewa,Fiche Hospital,Meskerem,1,2010,68,50,77,195
Oromia,Jimma,Kersa,Ginbot,9,2009,76,80,29,185
Oromia,West Wellega,Babo Gembel,Tir,5,2010,53,26,55,134
Oromia,West Wellega,Genji,Tahesas,4,2010,27,12,42,81
Oromia,East Wellega,Gida Ayana,Teqemt,2,2010,89,36,71,196
Oromia,Horo Gudru Wellega,Abay Chomen,Ginbot,9,2010,57,23,84,164
Oromia,West Shewa,Codi,Tir,5,2011,65,92,38,195
Oromia,West Wellega,Gimbi Adventist Hospital,Miyazia,8,2010,24,67,68,159
Oromia,West Wellega,Begi,Hedar,3,2011,21,73,77,171
Oromia,West Wellega,Gimbi,Yekatit,6,2010,22,90,31,143
Oromia,East Shewa,Gimbichu,Tahesas,4,2011,3,60,43,106
Oromia,West Hararge,Gelemso Hospital,Nehase,12,2009,71,15,72,158
Oromia,Bale,Meda Welabu,Ginbot,9,2011,29,42,45,116
Oromia,East Shewa,Batu,Hedar,3,2010,47,47,35,129
Oromia,Jimma,Setema,Tahesas,4,2011,26,59,76,161
Oromia,Finfine Zuria,Sululta Town,Tir,5,2011,51,84,1,136
Oromia,West Guji,Suro Barguda,Nehase,12,2010,25,96,37,158
Oromia,Guji,Shakiso Town,Megabit,7,2010,97,0,72,169
Oromia,Bale,Arena Buluq,Tir,5,2010,9,92,52,153
Oromia,Borena,Dubluk,Tahesas,4,2011,23,43,66,132
Oromia,East Shewa,Dugda,Tahesas,4,2010,74,32,97,203
Oromia,Qeleme Wellega,Kake Hosp,Miyazia,8,2011,35,34,92,161
Oromia,Buno Bedele,Dapho Hana,Sene,10,2011,24,70,16,110
Oromia,Guji,Anna Sora,Nehase,12,2010,45,20,20,85
Oromia,Arsi,Seru,Ginbot,9,2009,1,71,89,161
Oromia,East Hararge,Bisidimo Hospital,Hedar,3,2010,91,90,75,256
Oromia,East Hararge,Aweday Town,Sene,10,2010,33,59,92,184
Oromia,Guji,Anna Sora,Hamle,11,2010,80,20,27,127
Oromia,Borena,Yabelo Hospital,Miyazia,8,2010,15,95,96,206
Oromia,Ilu Aba Bora,Ale,Meskerem,1,2010,54,15,31,100
Oromia,Jimma,Nono Benja,Megabit,7,2009,7,55,30,92
Oromia,East Shewa,Batu,Meskerem,1,2010,79,87,72,238
Oromia,Burayu Town,Burayu Town,Miyazia,8,2010,24,71,59,154
Oromia,West Shewa,Dendi,Miyazia,8,2011,68,69,34,171
Oromia,Bale,Ginir,Hedar,3,2011,2,72,91,165
Oromia,Guji,Gumi Eldallo,Hedar,3,2011,1,17,42,60
Oromia,East Shewa,Adama,Meskerem,1,2011,1,88,84,173
Oromia,East Shewa,Gimbichu,Tir,5,2011,41,92,51,184
Oromia,East Hararge,Bisidimo Hospital,Hamle,11,2009,30,63,37,130
Oromia,Arsi,Chole,Miyazia,8,2010,85,67,6,158
Oromia,East Shewa,Adama,Tir,5,2010,78,93,69,240
Oromia,South West Shewa,Seden Sodo,Ginbot,9,2011,54,55,28,137
Oromia,Jimma,Kersa,Ginbot,9,2011,66,93,83,242
Oromia,Jimma,Chora Boter,Ginbot,9,2011,8,52,49,109
Oromia,Borena,Dilo,Miyazia,8,2010,16,26,59,101
Oromia,East Wellega,Gobu Seyo,Tahesas,4,2010,6,59,23,88
Oromia,East Wellega,Ebantu,Teqemt,2,2010,20,18,87,125
Oromia,West Wellega,Mene Sibu,Tahesas,4,2011,81,44,41,166
Oromia,East Hararge,Deder,Meskerem,1,2010,49,72,15,136
Oromia,Buno Bedele,Bedele Town,Hamle,11,2009,58,79,62,199
Oromia,West Arsi,Kofele,Hamle,11,2009,26,25,60,111
Oromia,East Hararge,Meyu Muleke,Nehase,12,2010,50,7,32,89
Oromia,East Hararge,Melka Belo,Megabit,7,2010,16,81,27,124
Oromia,East Hararge,Gursum,Yekatit,6,2009,5,12,30,47
Oromia,Bale,Gura Dhamole,Tir,5,2010,70,42,40,152
Oromia,Jimma,Shabe,Hedar,3,2011,7,37,70,114
Oromia,Finfine Zuria,Sandefa,Teqemt,2,2010,73,38,44,155
Oromia,Buno Bedele,Bedele Hospital,Tahesas,4,2010,60,2,99,161
Oromia,West Shewa,Tibe Kutaye,Yekatit,6,2009,38,91,20,149
Oromia,Woliso Town,Woliso Town,Ginbot,9,2010,46,20,85,151
Oromia,West Hararge,West Harerge	Gumbi Bordede,Hedar,3,2010,81,87,2,170
Oromia,Bale,Gololcha,Yekatit,6,2009,25,98,34,157
Oromia,Finfine Zuria,Sandefa,Meskerem,1,2011,51,20,94,165
Oromia,West Shewa,Adea Berga,Hamle,11,2009,46,4,81,131
Oromia,Borena,Guchi,Miyazia,8,2011,53,1,16,70
Oromia,Bale,Goro,Nehase,12,2009,25,65,19,109
Oromia,Jimma Spe Town,Jimma Spe Town,Miyazia,8,2009,57,22,41,120
Oromia,Guji,Gumi Eldallo,Nehase,12,2010,22,36,91,149
Oromia,East Wellega,Haro Limu,Miyazia,8,2011,53,23,96,172
Oromia,West Hararge,Oda Bultum,Miyazia,8,2010,77,18,72,167
Oromia,West Arsi,Kore,Nehase,12,2010,41,58,68,167
Oromia,North Shewa,Hidabu Abote,Megabit,7,2010,18,88,64,170
Oromia,East Hararge,Deder Hospital,Miyazia,8,2011,55,53,9,117
Oromia,South West Shewa,Woliso Town,Tir,5,2009,4,91,92,187
Oromia,Ilu Aba Bora,Nono Sele,Hamle,11,2010,41,48,89,178
Oromia,East Shewa,Batu,Hedar,3,2011,45,55,52,152
Oromia,East Shewa,Olanciti Hospital,Tir,5,2011,94,89,64,247
Oromia,North Shewa,Girar Jarso,Miyazia,8,2009,27,34,38,99
Oromia,West Arsi,Dodola Rural,Hedar,3,2011,7,47,20,74
Oromia,Ambo Town,Ambo Town,Ginbot,9,2010,77,4,3,84
Oromia,Guji,Adola Town,Megabit,7,2010,11,65,45,121
Oromia,East Shewa,Matahara,Megabit,7,2010,77,50,82,209
Oromia,East Wellega,Haro Limu,Sene,10,2009,90,9,75,174
Oromia,Jimma,Guma,Megabit,7,2009,18,80,16,114
Oromia,Ilu Aba Bora,Doreni,Tir,5,2009,76,11,76,163
Oromia,East Wellega,Sibu Sire,Sene,10,2009,17,39,21,77
Oromia,West Shewa,Bako Tibe,Nehase,12,2010,90,16,16,122
Oromia,North Shewa,Dera,Ginbot,9,2010,91,16,52,159
Oromia,West Arsi,Arsi Negele Rural,Tahesas,4,2010,82,33,80,195
Oromia,Finfine Zuria,Akaki,Megabit,7,2009,1,95,81,177
Oromia,West Shewa,Tikur Enchini,Sene,10,2011,40,80,50,170
Oromia,Bale,Goro,Teqemt,2,2010,49,47,69,165
Oromia,Bishoftu Town,Bishoftu Town,Nehase,12,2010,94,8,9,111
Oromia,West Shewa,Dendi,Nehase,12,2010,7,3,10,20
Oromia,Ilu Aba Bora,Ale,Teqemt,2,2011,55,7,63,125
Oromia,Ilu Aba Bora,Metu Town,Meskerem,1,2011,59,83,59,201
Oromia,Guji,Gumi Eldallo,Teqemt,2,2011,97,32,67,196
Oromia,Borena,Arero,Tahesas,4,2010,99,70,67,236
Oromia,West Shewa,Dendi,Tir,5,2011,45,26,57,128
Oromia,West Shewa,Adea Berga,Tahesas,4,2011,73,90,6,169
Oromia,West Shewa,Ambo,Sene,10,2010,33,49,3,85
Oromia,West Hararge,Chiro Town,Nehase,12,2010,9,5,77,91
Oromia,Guji,Shakiso Town,Tir,5,2011,13,28,42,83
Oromia,Buno Bedele,Dedesa,Miyazia,8,2011,48,73,98,219
Oromia,West Hararge,Burka Dimtu,Hamle,11,2010,3,49,19,71
Oromia,Qeleme Wellega,Laloqile,Megabit,7,2011,6,17,24,47
Oromia,East Shewa,Adea,Megabit,7,2010,39,7,18,64
Oromia,North Shewa,Degem,Hamle,11,2009,0,30,97,127
Oromia,Jimma,Seka Chekorsa,Ginbot,9,2009,53,72,38,163
Oromia,West Wellega,Begi Hospital,Yekatit,6,2010,32,38,78,148
Oromia,West Arsi,Kore,Meskerem,1,2011,76,42,3,121
Oromia,West Wellega,Jarso,Hedar,3,2011,6,12,26,44
Oromia,West Wellega,Nejo Rural,Yekatit,6,2009,33,68,14,115
Oromia,East Hararge,Aweday Town,Meskerem,1,2011,52,1,40,93
Oromia,West Shewa,Codi,Hamle,11,2010,67,26,17,110
Oromia,West Guji,Bule Hora Hospital,Miyazia,8,2009,52,42,21,115
Oromia,West Shewa,Gedo Hospital,Ginbot,9,2010,28,66,55,149
Oromia,South West Shewa,Ilu,Sene,10,2009,96,57,19,172
Oromia,Qeleme Wellega,Anfilo,Megabit,7,2010,64,43,39,146
Oromia,Qeleme Wellega,Sedan Chanka,Yekatit,6,2011,25,83,8,116
Oromia,West Shewa,Nono,Tir,5,2010,87,5,11,103
Oromia,Jimma,Sigmo,Meskerem,1,2011,55,70,44,169
Oromia,Jimma,Setema Hospital,Tir,5,2011,78,88,61,227
Oromia,Borena,Teltele,Teqemt,2,2011,94,3,12,109
Oromia,West Hararge,Anchar,Megabit,7,2010,75,13,86,174
Oromia,West Wellega,Babo Gembel,Meskerem,1,2011,87,66,85,238
Oromia,East Hararge,Girawa,Ginbot,9,2010,43,62,24,129
Oromia,Jimma,Sekoru,Teqemt,2,2010,15,36,13,64
Oromia,East Hararge,Garemuleta Hospital,Meskerem,1,2011,27,31,8,66
Oromia,West Hararge,Guba Qoricha,Megabit,7,2011,19,25,77,121
Oromia,Bishoftu Town,Bishoftu Town,Ginbot,9,2009,2,65,25,92
Oromia,North Shewa,Yaya Gulele,Meskerem,1,2011,3,62,84,149
Oromia,Guji,Aga Wayyu,Yekatit,6,2009,26,55,45,126
Oromia,Arsi,Bale Gesgara,Miyazia,8,2010,48,78,34,160
Oromia,West Shewa,Ambo Town,Hamle,11,2009,57,83,49,189
Oromia,Ilu Aba Bora,Darimu,Megabit,7,2010,97,89,93,279
Oromia,West Arsi,Kokosa  Hospital,Hedar,3,2011,38,96,63,197
Oromia,Bale,Legehida,Tahesas,4,2010,41,11,53,105
Oromia,Borena,Dilo,Hedar,3,2010,3,51,97,151
Oromia,Horo Gudru Wellega,Abay Chomen,Megabit,7,2009,63,1,79,143
Oromia,West Guji,Kercha,Yekatit,6,2010,87,18,17,122
Oromia,West Hararge,Tulo,Ginbot,9,2011,17,1,41,59
Oromia,Borena,Guchi,Tir,5,2011,5,37,66,108
Oromia,South West Shewa,Wonchi,Hedar,3,2010,67,4,0,71
Oromia,Finfine Zuria,Akaki,Tahesas,4,2011,28,22,70,120
Oromia,West Hararge,Hawi Gudina,Tir,5,2010,36,63,93,192
Oromia,East Shewa,Lomme,Teqemt,2,2010,83,34,7,124
Oromia,Arsi,Ludehetosa,Yekatit,6,2010,40,62,68,170
Oromia,Dukem Town,Dukem Town,Tir,5,2009,86,39,2,127
Oromia,West Shewa,Ambo Town,Meskerem,1,2010,64,32,54,150
Oromia,Guji,Aga Wayyu,Teqemt,2,2010,54,99,53,206
Oromia,West Wellega,Jarso,Tahesas,4,2010,50,15,8,73
Oromia,Qeleme Wellega,Hawa Gelan,Miyazia,8,2010,43,94,11,148
Oromia,Arsi,Tiyo,Yekatit,6,2011,79,86,61,226
Oromia,West Wellega,Gimbi Public  Hospital,Tir,5,2009,75,82,43,200
Oromia,Bale,Legehida,Tahesas,4,2011,51,36,48,135
Oromia,Qeleme Wellega,Dambi Dollo,Tahesas,4,2010,73,50,9,132
Oromia,East Hararge,Deder,Yekatit,6,2011,0,38,89,127
Oromia,East Shewa,Dugda,Miyazia,8,2009,73,40,13,126
Oromia,Qeleme Wellega,Laloqile,Teqemt,2,2010,59,51,39,149
Oromia,East Shewa,Olanciti Hospital,Tahesas,4,2011,88,41,36,165
Oromia,West Guji,Bule Hora Toun,Hamle,11,2009,88,62,3,153
Oromia,West Wellega,Mene Sibu,Yekatit,6,2009,36,42,56,134
Oromia,West Wellega,Nejo Rural,Ginbot,9,2009,0,37,80,117
Oromia,Bale,Dawe Qachen,Nehase,12,2009,6,14,55,75
Oromia,Guji,Shakiso Town,Ginbot,9,2009,77,30,69,176
Oromia,Buno Bedele,Boricha,Ginbot,9,2011,12,76,2,90
Oromia,Borena,Meyo,Nehase,12,2010,91,41,38,170
Oromia,Guji,Adola Hospital,Miyazia,8,2009,38,77,78,193
Oromia,West Wellega,Kundala,Megabit,7,2010,26,70,72,168
Oromia,Woliso Town,Woliso Town,Miyazia,8,2011,85,82,60,227
Oromia,Jimma,Dedo,Sene,10,2009,95,8,21,124
Oromia,East Shewa,Gimbichu,Megabit,7,2010,58,35,26,119
Oromia,Bale,Berbere,Yekatit,6,2011,21,21,38,80
Oromia,East Shewa,Batu,Tir,5,2010,77,72,42,191
Oromia,Qeleme Wellega,Seyo,Nehase,12,2009,4,60,98,162
Oromia,Qeleme Wellega,Dale Sedi,Megabit,7,2010,22,91,45,158
Oromia,East Hararge,Babile,Yekatit,6,2011,17,12,2,31
Oromia,Jimma,Limu Seka,Sene,10,2009,72,76,21,169
Oromia,West Shewa,Ginde Beret,Yekatit,6,2010,10,68,84,162
Oromia,East Hararge,Aweday Town,Yekatit,6,2009,8,15,15,38
Oromia,Guji,Wadara,Teqemt,2,2010,1,7,37,45
Oromia,West Arsi,Loke Hada Hospital,Tir,5,2011,18,91,36,145
Oromia,West Hararge,Burka Dimtu,Yekatit,6,2010,47,66,86,199
Oromia,Bale,Gura Dhamole,Miyazia,8,2009,78,93,28,199
Oromia,North Shewa,Dera Hospital,Ginbot,9,2011,59,24,76,159
Oromia,Arsi,Tena,Miyazia,8,2010,47,19,59,125
Oromia,Arsi,Merti,Nehase,12,2010,94,66,14,174
Oromia,Guji,Gumi Eldallo,Tahesas,4,2010,12,83,42,137
Oromia,East Wellega,Haro Limu,Miyazia,8,2009,4,23,93,120
Oromia,West Shewa,Jibat,Teqemt,2,2010,23,12,82,117
Oromia,West Guji,Hanbala,Ginbot,9,2011,96,59,56,211
Oromia,Horo Gudru Wellega,Amuru,Nehase,12,2009,56,11,47,114
Oromia,Jimma,Sekoru,Megabit,7,2010,69,74,53,196
Oromia,Qeleme Wellega,Dambi Dollo,Megabit,7,2009,6,30,23,59
Oromia,West Shewa,Abuna Gindeberet,Tir,5,2011,80,40,57,177
Oromia,Jimma,Tiro Afeta,Tahesas,4,2011,53,29,58,140
Oromia,West Shewa,Ambo,Tir,5,2010,88,69,96,253
Oromia,South West Shewa,Dawo,Yekatit,6,2010,24,84,71,179
Oromia,East Shewa,Dugda,Tir,5,2009,29,65,25,119
Oromia,East Shewa,Boset,Yekatit,6,2011,30,72,39,141
Oromia,Bale,Ginir,Ginbot,9,2009,75,60,21,156
Oromia,Ilu Aba Bora,Algesachi,Megabit,7,2011,77,44,16,137
Oromia,Buno Bedele,Chora,Ginbot,9,2010,25,21,48,94
Oromia,Borena,Dubluk,Miyazia,8,2009,75,0,89,164
Oromia,East Hararge,Kurfa Chele,Yekatit,6,2011,41,65,13,119
Oromia,East Hararge,Bedeno,Ginbot,9,2011,51,82,36,169
Oromia,Jimma,Limu Hospital,Tir,5,2009,57,7,70,134
Oromia,Horo Gudru Wellega,Horro Buluk,Sene,10,2011,5,53,15,73
Oromia,East Hararge,Deder,Miyazia,8,2010,24,30,83,137
Oromia,Ilu Aba Bora,Bure,Nehase,12,2009,47,13,29,89
Oromia,East Hararge,Goro Muti,Yekatit,6,2011,38,62,33,133
Oromia,East Shewa,Matahara,Miyazia,8,2010,94,70,21,185
Oromia,West Shewa,Tibe Kutaye,Sene,10,2010,48,9,40,97
Oromia,West Hararge,Tulo,Ginbot,9,2009,56,70,89,215
Oromia,East Wellega,Wama Hagelo,Ginbot,9,2011,2,21,82,105
Oromia,North Shewa,Hidabu Abote,Miyazia,8,2011,35,82,5,122
Oromia,Woliso Town,Woliso Town,Yekatit,6,2010,41,80,46,167
Oromia,East Hararge,Midega Tole,Miyazia,8,2010,65,93,53,211
Oromia,West Wellega,Babo Gembel,Miyazia,8,2011,68,39,49,156
Oromia,North Shewa,Jido,Sene,10,2009,50,18,84,152
Oromia,Arsi,Bale Gesgara,Tahesas,4,2011,37,83,57,177
Oromia,West Hararge,Habro,Megabit,7,2010,35,59,11,105
Oromia,East Hararge,Kumbi,Tir,5,2009,80,95,52,227
Oromia,West Guji,Kercha,Megabit,7,2009,84,76,90,250
Oromia,West Arsi,Bishan Guracha Town,Tir,5,2010,81,26,60,167
Oromia,Guji,Wadara,Ginbot,9,2010,48,70,18,136
Oromia,Buno Bedele,Meko,Hamle,11,2010,70,2,59,131
Oromia,Borena,Dilo,Hedar,3,2011,99,16,88,203
Oromia,West Shewa,Chelia,Miyazia,8,2010,65,18,18,101
Oromia,East Hararge,Kumbi,Hamle,11,2010,23,74,4,101
Oromia,Borena,Dilo,Megabit,7,2011,74,20,54,148
Oromia,Arsi,Munesa,Miyazia,8,2010,5,96,74,175
Oromia,West Hararge,Meiso,Ginbot,9,2011,69,52,22,143
Oromia,Guji,Shakiso Town,Miyazia,8,2010,13,62,12,87
Oromia,Borena,Yabelo Rural,Hedar,3,2010,43,66,52,161
Oromia,West Shewa,Guder Hosp,Meskerem,1,2011,72,92,59,223
Oromia,Bale,Legehida,Hedar,3,2010,77,81,41,199
Oromia,Ilu Aba Bora,Darimu,Miyazia,8,2009,16,16,75,107
Oromia,West Wellega,Ayira Hospital,Sene,10,2010,97,39,18,154
Oromia,Bale,Legehida,Megabit,7,2010,54,65,60,179
Oromia,Arsi,Seru,Tir,5,2010,4,97,9,110
Oromia,Sululta Town,Sululta Town,Meskerem,1,2010,90,5,39,134
Oromia,Guji,Aga Wayyu,Megabit,7,2011,62,6,95,163
Oromia,West Hararge,West Harerge	Gumbi Bordede,Teqemt,2,2011,83,73,90,246
Oromia,Finfine Zuria,Sululta Town,Sene,10,2010,84,85,14,183
Oromia,Qeleme Wellega,Dambi Dolo Hospital,Ginbot,9,2009,41,94,19,154
Oromia,Jimma,Mancho,Tahesas,4,2011,22,85,68,175
Oromia,Burayu Town,Burayu Town,Yekatit,6,2011,74,74,55,203
Oromia,East Hararge,Aweday Town,Yekatit,6,2009,11,23,95,129
Oromia,Borena,Guchi,Meskerem,1,2011,77,38,17,132
Oromia,West Shewa,Abuna Gindeberet,Tir,5,2011,73,92,59,224
Oromia,West Wellega,Seyo Nole,Yekatit,6,2009,60,14,70,144
Oromia,Bale,Gololcha,Teqemt,2,2010,57,57,33,147
Oromia,East Wellega,Boneya Bushe,Nehase,12,2010,22,22,28,72
Oromia,Borena,Yabelo Rural,Tir,5,2010,86,80,17,183
Oromia,Horo Gudru Wellega,Jima Rare,Hedar,3,2010,4,75,60,139
Oromia,Nekemte Town,Nekemte Town,Hedar,3,2011,71,72,92,235
Oromia,East Hararge,Girawa,Ginbot,9,2011,76,55,42,173
Oromia,East Hararge,Kombolicha,Hedar,3,2011,30,51,7,88
Oromia,Borena,Moyale Hospital,Yekatit,6,2009,88,39,79,206
Oromia,Buno Bedele,Dedesa,Hedar,3,2010,70,22,20,112
Oromia,West Shewa,Codi,Yekatit,6,2009,5,90,67,162
Oromia,East Hararge,Haromaya Hospital,Sene,10,2009,43,23,97,163
Oromia,Qeleme Wellega,Anfilo,Yekatit,6,2009,96,4,34,134
Oromia,West Wellega,Ayira Hospital,Tir,5,2010,9,95,43,147
Oromia,Nekemte Town,Nekemte Town,Sene,10,2010,66,6,24,96
Oromia,West Guji,Suro Barguda,Megabit,7,2010,31,17,50,98
Oromia,West Wellega,Genji,Sene,10,2009,0,5,20,25
Oromia,Arsi,Digeluna Tijo,Miyazia,8,2009,56,25,1,82
Oromia,East Shewa,Bora,Tir,5,2010,36,73,92,201
Oromia,Guji,Girja,Meskerem,1,2011,23,60,72,155
Oromia,West Wellega,Ayira Hospital,Ginbot,9,2010,21,86,48,155
Oromia,North Shewa,Were Jarso,Tir,5,2009,16,2,38,56
Oromia,Jimma,Dedo,Megabit,7,2011,3,18,98,119
Oromia,Arsi,Gololcha,Sene,10,2010,77,36,5,118
Oromia,Horo Gudru Wellega,Jima Rare,Megabit,7,2009,17,73,27,117
Oromia,Jimma,Limu Kosa,Hedar,3,2011,77,86,1,164
Oromia,Guji,Anna Sora,Teqemt,2,2010,26,44,30,100
Oromia,North Shewa,Aleiltu,Ginbot,9,2009,66,61,23,150
Oromia,Guji,Bore Hospital,Meskerem,1,2011,14,76,14,104
Oromia,Ilu Aba Bora,Nono Sele,Miyazia,8,2011,98,50,0,148
Oromia,West Shewa,Bako Tibe,Sene,10,2011,74,7,26,107
Oromia,North Shewa,Debre Libanos,Nehase,12,2010,20,93,51,164
Oromia,West Arsi,Arsi Negele Town,Sene,10,2011,57,53,56,166
Oromia,Horo Gudru Wellega,Jima Geneti,Tahesas,4,2011,99,95,12,206
Oromia,Borena,Dire,Ginbot,9,2009,38,55,4,97
Oromia,Arsi,Guna,Hamle,11,2010,18,1,93,112
Oromia,North Shewa,Kuyu Hospital,Nehase,12,2010,52,85,50,187
Oromia,Jimma,Omo Nada Hospital,Megabit,7,2011,73,82,92,247
Oromia,West Wellega,Yubdo,Meskerem,1,2011,74,16,2,92
Oromia,Arsi,Amigna,Hedar,3,2011,94,1,72,167
Oromia,Guji,Adola Hospital,Miyazia,8,2011,14,24,49,87
Oromia,East Hararge,Haromaya Town,Nehase,12,2010,36,21,83,140
Oromia,Guji,Negele Hospital,Meskerem,1,2011,78,88,44,210
Oromia,Bale,Legehida,Megabit,7,2010,31,41,64,136
Oromia,Qeleme Wellega,Dambi Dolo Hospital,Teqemt,2,2010,28,37,99,164
Oromia,West Hararge,Gemechis,Tahesas,4,2011,56,43,7,106
Oromia,East Shewa,Liben,Ginbot,9,2011,9,28,55,92
Oromia,West Wellega,Begi Hospital,Megabit,7,2011,42,57,48,147
Oromia,East Wellega,Guto Gida,Miyazia,8,2009,33,72,70,175
Oromia,Finfine Zuria,Sebeta Awas,Miyazia,8,2009,23,45,66,134
Oromia,West Wellega,Jarso,Yekatit,6,2010,79,80,58,217
Oromia,North Shewa,Abichugna,Ginbot,9,2011,21,93,95,209
Oromia,North Shewa,Degem,Nehase,12,2010,77,90,6,173
Oromia,Jimma,Shabe,Tir,5,2009,87,98,71,256
Oromia,Finfine Zuria,Akaki,Nehase,12,2010,72,96,40,208
Oromia,North Shewa,Debre Libanos,Teqemt,2,2010,12,8,99,119
Oromia,East Wellega,Jimma Arjo,Tir,5,2010,51,19,46,116
Oromia,Jimma,Nono Benja,Ginbot,9,2011,45,87,79,211
Oromia,West Wellega,Gimbi Public  Hospital,Sene,10,2009,93,40,17,150
Oromia,Arsi,Jeju,Hamle,11,2009,32,86,77,195
Oromia,Arsi,Amigna,Teqemt,2,2011,88,35,15,138
Oromia,West Hararge,Meiso,Meskerem,1,2011,64,70,75,209
Oromia,Qeleme Wellega,Dambi Dolo Hospital,Sene,10,2010,11,60,43,114
Oromia,West Hararge,Boke,Meskerem,1,2010,45,60,38,143
Oromia,Arsi,Jeju,Tir,5,2009,45,30,2,77
Oromia,Borena,Yabelo,Megabit,7,2009,68,48,41,157
Oromia,West Guji,Bule Hora Hospital,Sene,10,2009,70,7,40,117
Oromia,Jimma,Seka Chekorsa,Megabit,7,2009,22,22,7,51
Oromia,North Shewa,Fiche Hospital,Sene,10,2009,96,64,62,222
Oromia,East Shewa,Adama,Sene,10,2011,11,67,43,121
Oromia,West Shewa,Gindeberet Hospital,Tahesas,4,2010,45,61,58,164
Oromia,West Arsi,Dodola Town,Sene,10,2009,0,35,56,91
Oromia,East Shewa,Adami Tulu Jido Kombolcha,Meskerem,1,2011,99,11,29,139
Oromia,East Hararge,Kumbi,Hamle,11,2009,33,55,33,121
Oromia,Robe Town,Robe Town,Hedar,3,2011,99,74,20,193
Oromia,West Arsi,Arsi Negele Town,Hedar,3,2010,58,53,9,120
Oromia,South West Shewa,Goro,Nehase,12,2009,17,36,91,144
Oromia,Bale,Legehida,Nehase,12,2009,25,32,79,136
Oromia,Sebeta Town,Sebeta Town,Yekatit,6,2010,57,13,20,90
Oromia,West Shewa,Adea Berga,Megabit,7,2009,6,93,34,133
Oromia,South West Shewa,Woliso Rural,Ginbot,9,2011,30,77,59,166
Oromia,Jimma,B/Tolyi,Miyazia,8,2009,64,36,29,129
Oromia,Bale,Sinana,Hamle,11,2009,23,35,27,85
Oromia,West Arsi,Hebal Arsi,Sene,10,2010,25,39,44,108
Oromia,Arsi,Amigna,Ginbot,9,2010,92,19,12,123
Oromia,Horo Gudru Wellega,Abe Dengoro,Megabit,7,2010,3,15,21,39
Oromia,West Shewa,Ambo Hospital,Megabit,7,2010,20,42,53,115
Oromia,Arsi,Chole,Megabit,7,2010,57,22,71,150
Oromia,West Wellega,Mendi Hospital,Tir,5,2010,92,66,18,176
Oromia,North Shewa,Wuchale,Teqemt,2,2011,75,55,18,148
Oromia,West Wellega,Lata Sibu,Meskerem,1,2010,13,84,68,165
Oromia,East Wellega,Diga,Teqemt,2,2010,75,66,95,236
Oromia,Qeleme Wellega,Hawa Gelan,Sene,10,2010,7,95,31,133
Oromia,West Shewa,Tikur Enchini,Ginbot,9,2010,20,48,95,163
Oromia,West Arsi,Kokosa,Hedar,3,2010,92,99,17,208
Oromia,West Arsi,Arsi Negele Town,Tir,5,2010,70,13,41,124
Oromia,North Shewa,Jido,Tir,5,2009,39,28,33,100
Oromia,Qeleme Wellega,Dale Wabera,Ginbot,9,2010,41,85,43,169
Oromia,South West Shewa,Goro,Hedar,3,2010,3,78,40,121
Oromia,Ilu Aba Bora,Algesachi,Ginbot,9,2011,82,89,39,210
Oromia,West Hararge,Habro,Miyazia,8,2011,5,25,19,49
Oromia,Guji,Saba Boru,Megabit,7,2011,23,52,45,120
Oromia,Guji,Aga Wayyu,Hamle,11,2009,49,69,46,164
Oromia,West Wellega,Babo Gembel,Meskerem,1,2010,59,50,88,197
Oromia,West Shewa,Codi,Megabit,7,2010,80,98,88,266
Oromia,South West Shewa,Goro,Miyazia,8,2010,69,32,94,195
Oromia,Ilu Aba Bora,Yayu,Nehase,12,2010,97,64,50,211
Oromia,Arsi,Bekoji Town,Sene,10,2010,15,33,32,80
Oromia,Jimma Spe Town,Jimma Spe Town,Tir,5,2011,32,77,66,175
Oromia,West Wellega,Nejo Town,Yekatit,6,2011,2,6,11,19
Oromia,West Arsi,Dodola Town,Hamle,11,2010,22,45,13,80
Oromia,Horo Gudru Wellega,Shambu Town,Sene,10,2010,45,35,12,92
Oromia,Arsi,Aseko,Ginbot,9,2011,4,41,74,119
Oromia,West Arsi,Siraro,Hedar,3,2010,73,30,15,118
Oromia,North Shewa,Kuyu,Tir,5,2011,68,91,13,172
Oromia,West Arsi,Gedeb Asasa,Teqemt,2,2010,68,49,81,198
Oromia,West Arsi,Dodola Town,Tir,5,2011,7,72,79,158
Oromia,Arsi,Chole,Yekatit,6,2010,79,88,44,211
Oromia,East Wellega,Wama Hagelo,Nehase,12,2010,73,61,8,142
Oromia,East Wellega,Leqa Dulecha,Megabit,7,2011,74,48,18,140
Oromia,East Shewa,Liben,Hedar,3,2010,65,41,68,174
Oromia,South West Shewa,Wonchi,Yekatit,6,2011,44,27,95,166
Oromia,Arsi,Bale Gesgara,Miyazia,8,2010,14,19,68,101
Oromia,West Wellega,Mene Sibu,Nehase,12,2010,84,3,24,111
Oromia,Bale,Gololcha,Meskerem,1,2011,87,41,69,197
Oromia,Jimma,Guma,Ginbot,9,2010,97,56,50,203
Oromia,Horo Gudru Wellega,Hababo Guduru,Yekatit,6,2011,1,60,83,144
Oromia,East Hararge,Bedeno,Teqemt,2,2010,73,55,14,142
Oromia,West Shewa,Ginde Beret,Ginbot,9,2009,22,54,2,78
Oromia,East Wellega,Haro Limu,Tahesas,4,2011,35,66,48,149
Oromia,West Shewa,Nono,Megabit,7,2009,11,13,77,101
Oromia,West Shewa,Midakegni,Tir,5,2009,63,42,30,135
Oromia,Ilu Aba Bora,Becho,Nehase,12,2010,57,16,53,126
Oromia,West Arsi,Kokosa  Hospital,Sene,10,2011,99,57,76,232
Oromia,West Wellega,Lalo Asabi,Megabit,7,2011,5,81,95,181
Oromia,Arsi,Bale Gesgara,Megabit,7,2010,62,56,52,170
Oromia,West Hararge,Gemechis,Tir,5,2009,88,47,51,186
Oromia,Guji,Adola Town,Tahesas,4,2011,72,40,64,176
Oromia,West Arsi,Hebal Arsi,Ginbot,9,2011,46,99,82,227
Oromia,West Shewa,Abuna Gindeberet,Hamle,11,2009,56,36,74,166
Oromia,Arsi,Robe,Ginbot,9,2011,42,56,77,175
Oromia,Arsi,Deksis,Sene,10,2011,94,44,95,233
Oromia,West Guji,Biebirsa Kojowa,Megabit,7,2011,6,70,19,95
Oromia,Ilu Aba Bora,Yayu,Sene,10,2009,16,99,76,191
Oromia,Buno Bedele,Boricha,Miyazia,8,2011,32,70,88,190
Oromia,Lege Dadi Lege Tafo Town,Lege Dadi Lege Tafo Town,Hedar,3,2010,51,53,53,157
Oromia,Borena,El Way,Hedar,3,2010,28,70,87,185
Oromia,North Shewa,Were Jarso,Ginbot,9,2010,23,8,5,36
Oromia,Arsi,Hitosa,Meskerem,1,2010,22,81,47,150
Oromia,Bale,Gasera,Megabit,7,2010,22,22,64,108
Oromia,Bale,Berbere,Megabit,7,2009,18,15,21,54
Oromia,West Hararge,Oda Bultum,Miyazia,8,2010,14,69,23,106
Oromia,Bale,Gasera,Teqemt,2,2010,18,16,38,72
Oromia,Horo Gudru Wellega,Hababo Guduru,Teqemt,2,2011,23,83,23,129
Oromia,West Hararge,Doba,Ginbot,9,2011,1,59,80,140
Oromia,East Wellega,Jimma Arjo,Miyazia,8,2010,17,17,4,38
Oromia,Jimma,Agaro,Hamle,11,2009,45,5,91,141
Oromia,East Hararge,Fedis,Sene,10,2009,79,33,64,176
Oromia,Borena,Yabelo Rural,Tir,5,2010,52,41,82,175
Oromia,East Hararge,Aweday Town,Teqemt,2,2011,52,25,51,128
Oromia,Bale,Raitu,Sene,10,2010,59,98,75,232
Oromia,East Wellega,Gobu Seyo,Hamle,11,2009,79,2,17,98
Oromia,East Shewa,Adea,Miyazia,8,2010,65,64,33,162
Oromia,Qeleme Wellega,Gawo Qebe,Tir,5,2009,69,71,27,167
Oromia,Finfine Zuria,Sululta Town,Tir,5,2010,39,49,63,151
Oromia,Horo Gudru Wellega,Horo,Teqemt,2,2011,54,41,57,152
Oromia,Arsi,Enkelo Wabe,Nehase,12,2010,86,53,21,160
Oromia,Buno Bedele,Dedesa,Nehase,12,2009,69,63,97,229
Oromia,East Hararge,Kurfa Chele,Sene,10,2009,32,4,46,82
Oromia,Arsi,Shirka,Megabit,7,2010,86,60,62,208
Oromia,West Shewa,Gedo Hospital,Sene,10,2010,78,86,76,240
Oromia,Ilu Aba Bora,Bure,Ginbot,9,2011,0,45,48,93
Oromia,Jimma,Mancho,Megabit,7,2009,43,83,79,205
Oromia,Horo Gudru Wellega,Jima Geneti,Meskerem,1,2010,1,49,44,94
Oromia,Ilu Aba Bora,Doreni,Tir,5,2009,88,54,74,216
Oromia,Qeleme Wellega,Dale Sedi,Tir,5,2010,70,49,82,201
Oromia,East Wellega,Wayu Tuqa,Megabit,7,2009,0,74,8,82
Oromia,Arsi,Tiyo,Miyazia,8,2010,54,41,48,143
Oromia,East Wellega,Diga,Megabit,7,2011,74,58,38,170
Oromia,Horo Gudru Wellega,Abe Dengoro,Miyazia,8,2009,6,63,98,167
Oromia,West Hararge,Chiro Zuriya,Tir,5,2009,75,20,99,194
Oromia,South West Shewa,Seden Sodo,Hamle,11,2010,47,16,65,128
Oromia,Qeleme Wellega,Gawo Qebe,Sene,10,2009,85,0,45,130
Oromia,Qeleme Wellega,Dale Wabera,Meskerem,1,2010,64,63,70,197
Oromia,Horo Gudru Wellega,Horro Buluk,Nehase,12,2010,79,60,39,178
Oromia,Guji,Uraga,Miyazia,8,2009,71,8,6,85
Oromia,Jimma,Gera,Tir,5,2010,3,8,93,104
Oromia,Arsi,Zeway Dugda,Tahesas,4,2011,65,42,12,119
Oromia,West Arsi,Hebal Arsi,Megabit,7,2010,29,75,30,134
Oromia,West Wellega,Babo Gembel,Tir,5,2010,27,35,90,152
Oromia,Qeleme Wellega,Laloqile,Ginbot,9,2011,34,73,42,149
Oromia,East Wellega,Leqa Dulecha,Yekatit,6,2009,73,30,10,113
Oromia,Bale,Ginir Town,Nehase,12,2010,76,11,37,124
Oromia,East Hararge,Chinakesen,Sene,10,2011,65,51,85,201
Oromia,Qeleme Wellega,Gawo Qebe,Tir,5,2010,94,40,56,190
Oromia,West Hararge,Meiso,Sene,10,2009,8,96,97,201
Oromia,North Shewa,Abichugna,Nehase,12,2010,22,70,75,167
Oromia,West Wellega,Genji,Tir,5,2009,44,81,38,163
Oromia,Bale,Dinsho,Tir,5,2010,89,78,36,203
Oromia,Gelan Town,Gelan Town,Tir,5,2009,71,50,14,135
Oromia,Finfine Zuria,Sebeta Awas,Tir,5,2011,15,4,18,37
Oromia,Borena,Yabelo Rural,Tir,5,2010,40,60,70,170
Oromia,West Arsi,Gambo Hospital,Nehase,12,2009,57,6,45,108
Oromia,West Shewa,Ambo,Tahesas,4,2011,54,11,11,76
Oromia,West Hararge,Chiro Town,Meskerem,1,2010,49,73,0,122
Oromia,Arsi,Digeluna Tijo,Ginbot,9,2011,49,32,68,149
Oromia,Arsi,Deksis,Hamle,11,2009,33,25,55,113
Oromia,West Wellega,Genji,Hedar,3,2011,1,53,54,108
Oromia,East Hararge,Haromaya Rural,Nehase,12,2010,90,14,76,180
Oromia,West Hararge,Chiro Zuriya,Sene,10,2011,71,13,53,137
Oromia,Ilu Aba Bora,Ale,Miyazia,8,2009,44,76,6,126
Oromia,Buno Bedele,Boricha,Tahesas,4,2010,68,25,80,173
Oromia,East Wellega,Boneya Bushe,Miyazia,8,2011,88,85,10,183
Oromia,East Hararge,Haromaya Town,Hedar,3,2011,5,71,11,87
Oromia,West Shewa,Jeldu,Hamle,11,2009,78,46,23,147
Oromia,Guji,Saba Boru,Hamle,11,2009,40,88,59,187
Oromia,East Wellega,Gida Ayana,Meskerem,1,2011,30,93,75,198
Oromia,Ilu Aba Bora,Hurumu,Ginbot,9,2010,70,69,7,146
Oromia,West Guji,Dugda Dawa,Tir,5,2009,86,97,45,228
Oromia,South West Shewa,Becho,Miyazia,8,2011,70,10,51,131
Oromia,South West Shewa,Sodo Dac'Ha,Miyazia,8,2011,98,61,20,179
Oromia,Buno Bedele,Dedesa,Meskerem,1,2010,22,87,4,113
Oromia,North Shewa,Dera,Miyazia,8,2011,66,92,19,177
Oromia,West Shewa,Meta Waliqite,Teqemt,2,2010,14,83,80,177
Oromia,East Hararge,Haromaya Hospital,Megabit,7,2010,6,48,64,118
Oromia,West Wellega,Jarso,Tir,5,2009,24,61,78,163
Oromia,South West Shewa,Bantu  Hospital,Teqemt,2,2011,53,14,40,107
Oromia,Arsi,Limuna Bilbilo,Miyazia,8,2010,26,79,96,201
Oromia,West Hararge,Mesela,Hedar,3,2011,81,72,13,166
Oromia,Arsi,Deksis,Tahesas,4,2010,33,94,15,142
Oromia,West Shewa,Codi,Tahesas,4,2010,36,16,79,131
Oromia,East Shewa,Olanciti Hospital,Sene,10,2009,48,69,91,208
Oromia,Jimma,Mana,Yekatit,6,2010,65,21,28,114
Oromia,West Hararge,Boke,Nehase,12,2009,37,5,13,55
Oromia,South West Shewa,Kersana Malima,Sene,10,2011,26,66,22,114
Oromia,East Wellega,Leqa Dulecha,Miyazia,8,2009,96,42,39,177
Oromia,East Hararge,Haromaya Rural,Megabit,7,2011,52,81,33,166
Oromia,East Wellega,Boneya Bushe,Tir,5,2009,53,5,19,77
Oromia,Jimma,Nono Benja,Yekatit,6,2011,86,19,63,168
Oromia,Jimma,Sekoru,Teqemt,2,2011,40,71,92,203
Oromia,Bale,Sinana,Ginbot,9,2011,93,18,63,174
Oromia,West Wellega,Seyo Nole,Miyazia,8,2009,65,50,41,156
Oromia,Bishoftu Town,Bishoftu Town,Teqemt,2,2010,60,81,14,155
Oromia,Jimma,Setema Hospital,Nehase,12,2010,82,23,91,196
Oromia,Guji,Negele Hospital,Hamle,11,2009,44,44,9,97
Oromia,Borena,Arero,Teqemt,2,2011,85,5,8,98
Oromia,Arsi,Bale Gesgara,Nehase,12,2009,4,5,15,24
Oromia,East Hararge,Chinakesen,Teqemt,2,2011,92,34,56,182
Oromia,Buno Bedele,Boricha,Yekatit,6,2009,51,23,22,96
Oromia,West Shewa,Midakegni,Tir,5,2011,3,7,76,86
Oromia,Finfine Zuria,Walmera,Sene,10,2010,63,93,28,184
Oromia,Borena,Gomole,Ginbot,9,2011,22,83,65,170
Oromia,West Hararge,Gemechis,Meskerem,1,2011,96,33,45,174
Oromia,West Wellega,Boji Cheqorsa,Teqemt,2,2010,94,0,45,139
Oromia,East Hararge,Garemuleta Hospital,Teqemt,2,2011,62,60,24,146
Oromia,Guji,Uraga,Nehase,12,2010,67,54,0,121
Oromia,West Wellega,Mendi Town,Nehase,12,2010,3,97,45,145
Oromia,West Hararge,West Harerge	Gumbi Bordede,Hamle,11,2010,46,69,64,179
Oromia,North Shewa,Wuchale,Ginbot,9,2011,21,6,91,118
Oromia,West Wellega,Gimbi Public  Hospital,Megabit,7,2010,39,74,95,208
Oromia,West Arsi,Hebal Arsi,Miyazia,8,2010,25,88,44,157
Oromia,West Wellega,Seyo Nole,Hamle,11,2009,26,97,13,136
Oromia,Finfine Zuria,Sululta Town,Yekatit,6,2009,82,15,68,165
Oromia,Jimma,Seka Chhokorsa Hospital,Megabit,7,2011,57,30,8,95
Oromia,West Arsi,Shala,Megabit,7,2009,29,0,54,83
Oromia,South West Shewa,Wonchi,Hedar,3,2011,26,31,16,73
Oromia,West Arsi,Siraro,Nehase,12,2009,64,4,28,96
Oromia,Jimma,Tiro Afeta,Tir,5,2011,48,59,11,118
Oromia,Buno Bedele,Diga,Meskerem,1,2011,47,32,43,122
Oromia,East Shewa,Mojo,Nehase,12,2009,1,16,27,44
Oromia,Borena,Dilo,Ginbot,9,2011,46,83,0,129
Oromia,West Wellega,Nejo Rural,Ginbot,9,2010,92,71,17,180
Oromia,Guji,Anna Sora,Tahesas,4,2010,9,66,84,159
Oromia,East Hararge,Midega Tole,Yekatit,6,2011,66,61,65,192
Oromia,East Shewa,Matahara,Hedar,3,2011,79,61,45,185
Oromia,West Arsi,Adaba,Megabit,7,2011,23,47,47,117
Oromia,West Arsi,Kokosa,Hedar,3,2010,93,96,24,213
Oromia,West Shewa,Meta Waliqite,Meskerem,1,2011,36,33,27,96
Oromia,Arsi,Chole,Megabit,7,2009,90,55,74,219
Oromia,East Shewa,Batu,Miyazia,8,2011,96,31,61,188
Oromia,Bale,Gasera,Hamle,11,2010,14,92,13,119
Oromia,Guji,Bore Hospital,Meskerem,1,2011,11,64,11,86
Oromia,Jimma,Nono Benja,Teqemt,2,2010,74,84,88,246
Oromia,Jimma,Gomma,Hamle,11,2010,87,24,53,164
Oromia,West Hararge,Oda Bultum,Megabit,7,2010,77,60,37,174
Oromia,West Wellega,Mendi Hospital,Miyazia,8,2011,13,69,17,99
Oromia,East Wellega,Sasiga,Teqemt,2,2010,40,29,34,103
Oromia,East Wellega,Diga,Tir,5,2009,98,46,45,189
Oromia,East Hararge,Melka Belo,Megabit,7,2009,80,21,83,184
Oromia,Horo Gudru Wellega,Horro Buluk,Hedar,3,2010,57,91,61,209
Oromia,Jimma,Seka Chekorsa,Nehase,12,2010,74,31,21,126
Oromia,Ilu Aba Bora,Yayu,Ginbot,9,2010,82,74,33,189
Oromia,Finfine Zuria,Berreh,Sene,10,2009,38,47,83,168
Oromia,West Arsi,Siraro,Miyazia,8,2011,15,19,7,41
Oromia,East Hararge,Kurfa Chele,Miyazia,8,2010,69,56,12,137
Oromia,East Hararge,Fedis,Hedar,3,2011,21,89,8,118
Oromia,East Wellega,Wayu Tuqa,Ginbot,9,2010,2,21,40,63
Oromia,Ilu Aba Bora,Becho,Nehase,12,2010,43,17,86,146
Oromia,East Wellega,Sibu Sire,Hedar,3,2011,29,53,35,117
Oromia,East Wellega,Gobu Seyo,Tir,5,2011,16,22,6,44
Oromia,Finfine Zuria,Sandefa,Tir,5,2010,34,70,20,124
Oromia,Bale,Meda Welabu,Yekatit,6,2010,49,31,27,107
Oromia,East Shewa,Adea,Yekatit,6,2010,38,91,39,168
Oromia,Ilu Aba Bora,Hurumu,Miyazia,8,2009,58,30,96,184
Oromia,West Shewa,Ambo,Meskerem,1,2011,86,57,54,197
Oromia,East Hararge,Babile Woreda,Yekatit,6,2010,34,50,69,153
Oromia,West Wellega,Jarso,Ginbot,9,2009,53,84,69,206
Oromia,Guji,Shakiso Town,Miyazia,8,2010,61,84,28,173
Oromia,Qeleme Wellega,Dambi Dolo Hospital,Tir,5,2009,26,5,3,34
Oromia,North Shewa,Fichetown,Miyazia,8,2010,39,8,39,86
Oromia,South West Shewa,Goro,Nehase,12,2010,13,6,8,27
Oromia,North Shewa,Wuchale,Yekatit,6,2011,92,78,64,234
Oromia,East Wellega,Wama Hagelo,Hamle,11,2010,31,90,55,176
Oromia,North Shewa,Degem,Yekatit,6,2009,15,52,39,106
Oromia,West Hararge,Chiro Town,Tir,5,2011,47,46,82,175
Oromia,Ilu Aba Bora,Bure,Miyazia,8,2010,9,69,16,94
Oromia,West Shewa,Tibe Kutaye,Megabit,7,2010,25,26,58,109
Oromia,Adama Special Town,Adama Town,Teqemt,2,2011,48,63,69,180
Oromia,West Shewa,Tikur Enchini,Miyazia,8,2010,58,53,11,122
Oromia,East Shewa,Lomme,Miyazia,8,2010,53,29,90,172
Oromia,West Arsi,Kore,Yekatit,6,2009,35,23,69,127
Oromia,Bale,Gura Dhamole,Meskerem,1,2010,45,51,73,169
Oromia,Jimma,Kersa,Meskerem,1,2011,97,91,21,209
Oromia,West Hararge,Burka Dimtu,Yekatit,6,2010,19,36,63,118
Oromia,West Shewa,Dendi,Miyazia,8,2011,14,22,83,119
Oromia,West Shewa,Ejersa Lafo,Sene,10,2009,59,14,72,145
Oromia,Gelan Town,Gelan Town,Tir,5,2010,96,60,44,200
Oromia,Bale,Dinsho,Hamle,11,2010,98,65,33,196
Oromia,Guji,Negele Hospital,Hedar,3,2011,92,18,26,136
Oromia,West Hararge,Oda Bultum,Tahesas,4,2010,52,97,13,162
Oromia,North Shewa,Kuyu Hospital,Tir,5,2011,65,96,77,238
Oromia,West Wellega,Lalo Asabi,Hamle,11,2009,49,90,11,150
Oromia,East Hararge,Garemuleta Hospital,Ginbot,9,2011,5,62,89,156
Oromia,North Shewa,Wuchale,Nehase,12,2009,74,25,6,105
Oromia,West Wellega,Jarso,Ginbot,9,2011,93,12,48,153
Oromia,West Wellega,Nejo Hospital,Tir,5,2011,19,39,96,154
Oromia,East Hararge,Gursum,Megabit,7,2009,2,49,98,149
Oromia,West Hararge,Meiso,Tahesas,4,2011,35,45,23,103
Oromia,North Shewa,Wuchale,Megabit,7,2010,53,34,27,114
Oromia,Ilu Aba Bora,Bilonopa,Yekatit,6,2010,1,7,63,71
Oromia,East Hararge,Meta,Hamle,11,2009,55,31,94,180
Oromia,Arsi,Munesa,Teqemt,2,2010,10,92,9,111
Oromia,West Wellega,Boji Dermeji,Miyazia,8,2010,54,29,81,164
Oromia,West Shewa,Gojo Hospital,Megabit,7,2009,18,50,98,166
Oromia,North Shewa,Fichetown,Tir,5,2011,70,54,20,144
Oromia,West Shewa,Gedo Hospital,Tir,5,2010,39,41,67,147
Oromia,East Shewa,Bora,Tir,5,2009,90,7,79,176
Oromia,West Arsi,Nensebo,Hedar,3,2011,12,23,12,47
Oromia,South West Shewa,Ameya Hospital,Hedar,3,2011,44,44,99,187
Oromia,Arsi,Aseko,Miyazia,8,2009,14,92,22,128
Oromia,Bale,Berbere,Hamle,11,2009,3,22,50,75
Oromia,Jimma,Kersa,Miyazia,8,2010,10,34,64,108
Oromia,Finfine Zuria,Akaki,Yekatit,6,2010,52,46,92,190
Oromia,East Hararge,Babile,Nehase,12,2010,74,27,92,193
Oromia,South West Shewa,Kersana Malima,Nehase,12,2010,32,4,4,40
Oromia,West Wellega,Boji Cheqorsa,Tir,5,2011,77,22,4,103
Oromia,Arsi,Tena,Nehase,12,2009,95,40,81,216
Oromia,West Shewa,Jibat,Tahesas,4,2010,6,95,70,171
Oromia,West Arsi,Kore,Miyazia,8,2011,89,47,41,177
Oromia,West Arsi,Kokosa,Sene,10,2010,30,27,93,150
Oromia,North Shewa,Girar Jarso,Hedar,3,2011,16,25,95,136
Oromia,West Wellega,Haru,Ginbot,9,2009,99,44,25,168
Oromia,East Hararge,Babile Woreda,Tir,5,2010,45,83,27,155
Oromia,West Wellega,Ayira,Nehase,12,2009,89,45,97,231
Oromia,West Shewa,Gojo Hospital,Yekatit,6,2009,31,20,75,126
Oromia,South West Shewa,Ameya,Nehase,12,2010,25,76,39,140
Oromia,Guji,Adola Reda,Ginbot,9,2011,88,8,27,123
Oromia,Arsi,Tena,Ginbot,9,2011,56,57,55,168
Oromia,Arsi,Munesa,Nehase,12,2010,45,70,41,156
Oromia,East Shewa,Olanciti Hospital,Megabit,7,2010,72,17,46,135
Oromia,East Wellega,Jimma Arjo,Yekatit,6,2011,79,91,70,240
Oromia,Qeleme Wellega,Seyo,Hamle,11,2010,99,11,69,179
Oromia,West Guji,Gelana,Sene,10,2010,99,69,39,207
Oromia,West Shewa,Midakegni,Hedar,3,2011,42,13,77,132
Oromia,East Hararge,Deder Hospital,Hamle,11,2009,23,83,61,167
Oromia,East Shewa,Adama,Tir,5,2011,89,81,42,212
Oromia,West Hararge,Habro,Tir,5,2011,19,14,55,88
Oromia,East Hararge,Aweday Town,Sene,10,2010,70,45,24,139
Oromia,West Shewa,Inchini Hospital,Hamle,11,2010,89,56,42,187
Oromia,East Shewa,Adama,Miyazia,8,2011,51,13,80,144
Oromia,West Hararge,Oda Bultum,Tahesas,4,2010,57,35,28,120
Oromia,Guji,Dima,Megabit,7,2009,18,30,64,112
Oromia,West Shewa,Jeldu,Megabit,7,2010,5,1,70,76
Oromia,East Wellega,Gida Ayana,Ginbot,9,2011,38,53,40,131
Oromia,West Shewa,Ginde Beret,Tahesas,4,2011,92,94,53,239
Oromia,West Wellega,Gimbi Rural,Ginbot,9,2011,2,28,89,119
Oromia,West Guji,Bule Hora,Tahesas,4,2010,34,31,46,111
Oromia,East Hararge,Bedeno,Megabit,7,2010,57,52,67,176
Oromia,West Shewa,Tibe Kutaye,Hamle,11,2009,35,90,99,224
Oromia,Bale,Ginir Town,Meskerem,1,2011,85,86,16,187
Oromia,Bale,Gasera,Megabit,7,2011,35,75,89,199
Oromia,West Arsi,Dodola Town,Sene,10,2009,82,36,66,184
Oromia,East Hararge,Haromaya Town,Megabit,7,2011,6,43,80,129
Oromia,East Hararge,Chinakesen,Megabit,7,2009,5,48,59,112
Oromia,West Wellega,Kundala,Hedar,3,2011,53,3,52,108
Oromia,West Shewa,Codi,Hedar,3,2011,67,17,45,129
Oromia,East Shewa,Adami Tulu Jido Kombolcha,Miyazia,8,2009,79,34,40,153
Oromia,Bale,Raitu,Miyazia,8,2010,73,82,50,205
Oromia,East Hararge,Haromaya Hospital,Tahesas,4,2011,94,2,80,176
Oromia,Ilu Aba Bora,Nono Sele,Sene,10,2010,61,86,76,223
Oromia,West Hararge,Chiro Town,Megabit,7,2011,29,91,33,153
Oromia,East Wellega,Sasiga,Hamle,11,2009,98,99,38,235
Oromia,Gelan Town,Gelan Town,Meskerem,1,2010,21,23,15,59
Oromia,West Arsi,Gambo Hospital,Nehase,12,2010,35,2,97,134
Oromia,Borena,Arero,Ginbot,9,2011,64,1,20,85
Oromia,Ilu Aba Bora,Yayu,Miyazia,8,2010,12,38,95,145
Oromia,West Shewa,Midakegni,Meskerem,1,2011,47,77,26,150
Oromia,West Shewa,Codi,Sene,10,2009,77,73,47,197
Oromia,East Hararge,Chinakesen,Hedar,3,2010,34,82,11,127
Oromia,West Guji,Dugda Dawa,Sene,10,2011,14,18,86,118
Oromia,East Shewa,Batu,Ginbot,9,2010,92,81,60,233
Oromia,West Hararge,Mesela,Hedar,3,2011,10,91,43,144
Oromia,Qeleme Wellega,Gidami,Hedar,3,2011,76,81,98,255
Oromia,Arsi,Merti,Teqemt,2,2010,61,97,35,193
Oromia,Horo Gudru Wellega,Shambu Hospital,Tahesas,4,2011,76,19,65,160
Oromia,Arsi,Merti,Megabit,7,2011,83,41,34,158
Oromia,East Wellega,Limu,Ginbot,9,2009,68,89,92,249
Oromia,Qeleme Wellega,Dambi Dolo Hospital,Hedar,3,2011,65,95,80,240
Oromia,Bishoftu Town,Bishoftu Town,Ginbot,9,2010,78,37,19,134
Oromia,Bale,Sinana,Megabit,7,2009,90,65,26,181
Oromia,East Hararge,Aweday Town,Yekatit,6,2011,73,26,2,101
Oromia,Buno Bedele,Diga,Teqemt,2,2010,96,57,66,219
Oromia,West Shewa,Codi,Tir,5,2009,12,31,41,84
Oromia,West Hararge,Chiro Zuriya,Hedar,3,2010,31,20,49,100
Oromia,East Hararge,Garemuleta Hospital,Meskerem,1,2011,97,70,89,256
Oromia,Buno Bedele,Diga,Hamle,11,2010,4,60,83,147
Oromia,Qeleme Wellega,Yemalogi Wolel,Yekatit,6,2009,50,46,8,104
Oromia,West Wellega,Gimbi Adventist Hospital,Ginbot,9,2009,62,54,83,199
Oromia,West Arsi,Nensebo,Tir,5,2011,70,89,36,195
Oromia,West Guji,Kercha,Ginbot,9,2009,25,15,57,97
Oromia,West Shewa,Dendi,Ginbot,9,2011,53,92,94,239
Oromia,Qeleme Wellega,Kake Hosp,Hedar,3,2011,99,87,61,247
Oromia,West Shewa,Midakegni,Megabit,7,2009,19,76,91,186
Oromia,West Shewa,Ginde Beret,Tir,5,2011,32,26,48,106
Oromia,Holeta Town,Holeta Town,Hamle,11,2010,59,48,98,205
Oromia,West Guji,Gelana,Miyazia,8,2011,63,93,46,202
Oromia,Ilu Aba Bora,Yayu,Ginbot,9,2011,94,2,92,188
Oromia,West Shewa,Ambo Town,Hamle,11,2009,11,44,99,154
Oromia,Arsi,Robe,Ginbot,9,2011,45,45,7,97
Oromia,West Guji,Dugda Dawa,Ginbot,9,2010,33,95,32,160
Oromia,West Hararge,Chiro Zuriya,Megabit,7,2010,99,4,47,150
Oromia,West Hararge,Anchar,Meskerem,1,2010,8,87,97,192
Oromia,Dukem Town,Dukem Town,Yekatit,6,2009,43,29,0,72
Oromia,Jimma,Agaro Hospital,Yekatit,6,2011,89,32,58,179
Oromia,Bale,Goba,Meskerem,1,2010,93,18,4,115
Oromia,Jimma,Tiro Afeta,Miyazia,8,2009,71,28,30,129
Oromia,West Arsi,Kore,Tir,5,2011,21,14,53,88
Oromia,Borena,Teltele,Yekatit,6,2011,8,41,90,139
Oromia,Bale,Seweyna,Teqemt,2,2011,10,33,87,130
Oromia,East Hararge,Chinakesen,Miyazia,8,2009,3,93,38,134
Oromia,Guji,Negele Town,Ginbot,9,2009,30,48,0,78
Oromia,Bale,Ginir Town,Hedar,3,2010,16,64,12,92
Oromia,Bale,Meda Welabu,Ginbot,9,2011,93,91,85,269
Oromia,Finfine Zuria,Mullo,Sene,10,2011,89,58,76,223
Oromia,West Arsi,Siraro,Hamle,11,2009,83,96,98,277
Oromia,Bale,Meda Welabu,Yekatit,6,2010,20,77,48,145
Oromia,West Wellega,Begi,Miyazia,8,2010,82,81,15,178
Oromia,Borena,Arero,Tahesas,4,2011,47,52,89,188
Oromia,Lege Dadi Lege Tafo Town,Lege Dadi Lege Tafo Town,Yekatit,6,2009,18,74,65,157
Oromia,South West Shewa,Dawo,Ginbot,9,2010,96,57,75,228
Oromia,South West Shewa,Wonchi,Hedar,3,2010,25,88,94,207
Oromia,Guji,Anna Sora,Ginbot,9,2011,32,58,20,110
Oromia,Qeleme Wellega,Dale Wabera,Megabit,7,2009,72,72,4,148
Oromia,East Hararge,Babile Woreda,Sene,10,2010,62,82,36,180
Oromia,Buno Bedele,Dedesa,Megabit,7,2011,13,54,27,94
Oromia,Buno Bedele,Gechi,Hamle,11,2010,17,91,29,137
Oromia,North Shewa,Wuchale,Miyazia,8,2011,90,16,12,118
Oromia,North Shewa,Dera,Sene,10,2010,25,63,17,105
Oromia,West Wellega,Begi,Hedar,3,2011,68,18,74,160
Oromia,West Wellega,Nejo Hospital,Yekatit,6,2009,82,0,71,153
Oromia,Sululta Town,Sululta Town,Ginbot,9,2011,9,62,49,120
Oromia,Horo Gudru Wellega,Shambu Hospital,Ginbot,9,2011,53,43,38,134
Oromia,West Hararge,Doba,Tir,5,2009,66,37,5,108
Oromia,Finfine Zuria,Mullo,Nehase,12,2010,60,5,37,102
Oromia,Finfine Zuria,Walmera,Hedar,3,2011,4,22,38,64
Oromia,Ilu Aba Bora,Metu Town,Tir,5,2010,14,61,0,75
Oromia,West Hararge,Chiro Hospital,Ginbot,9,2010,68,62,60,190
Oromia,West Arsi,Nensebo,Hedar,3,2010,41,45,87,173
Oromia,Arsi,Seru,Ginbot,9,2010,73,43,57,173
Oromia,Jimma,Seka Chekorsa,Tir,5,2009,1,3,60,64
Oromia,West Arsi,Shashemene Rural,Tahesas,4,2010,48,77,42,167
Oromia,East Hararge,Midega Tole,Tahesas,4,2010,87,62,81,230
Oromia,Borena,Wachile,Megabit,7,2009,80,6,99,185
Oromia,West Wellega,Genji,Hedar,3,2010,51,52,69,172
Oromia,Borena,Moyale Hospital,Teqemt,2,2010,37,14,51,102
Oromia,West Wellega,Seyo Nole,Yekatit,6,2010,72,49,75,196
Oromia,East Shewa,Gimbichu,Yekatit,6,2009,51,56,4,111
Oromia,West Arsi,Wondo,Megabit,7,2010,93,85,31,209
Oromia,Jimma,Sekoru,Tahesas,4,2011,86,13,23,122
Oromia,North Shewa,Yaya Gulele,Tir,5,2011,90,66,84,240
Oromia,West Hararge,Chiro Zuriya,Hedar,3,2011,22,31,98,151
Oromia,Bale,Ginir Town,Sene,10,2009,92,52,39,183
Oromia,Bale,Meda Welabu,Sene,10,2011,79,94,40,213
Oromia,Arsi,Seru,Meskerem,1,2010,15,9,39,63
Oromia,Bale,Dinsho,Hedar,3,2010,64,47,42,153
Oromia,West Shewa,Abuna Gindeberet,Hamle,11,2010,57,72,22,151
Oromia,Buno Bedele,Boricha,Nehase,12,2010,19,21,83,123
Oromia,East Shewa,Adea,Nehase,12,2009,92,58,20,170
Oromia,South West Shewa,Seden Sodo,Hedar,3,2010,30,94,29,153
Oromia,Ambo Town,Ambo Town,Tahesas,4,2010,25,74,6,105
Oromia,West Hararge,Meiso,Nehase,12,2009,6,77,16,99
Oromia,Arsi,Enkelo Wabe,Yekatit,6,2010,38,80,32,150
Oromia,Borena,Meyo,Megabit,7,2009,95,90,5,190
Oromia,West Shewa,Ambo Hospital,Tahesas,4,2011,34,61,81,176
Oromia,Horo Gudru Wellega,Horo,Tir,5,2009,59,96,86,241
Oromia,Jimma,Shabe,Hamle,11,2010,46,88,87,221
Oromia,East Hararge,Deder Hospital,Hamle,11,2010,14,27,79,120
Oromia,West Wellega,Nejo Town,Megabit,7,2011,10,55,87,152
Oromia,West Guji,Bule Hora Toun,Megabit,7,2011,56,10,50,116
Oromia,West Arsi,Wondo,Miyazia,8,2010,15,21,54,90
Oromia,West Wellega,Gimbi Adventist Hospital,Hedar,3,2010,99,62,96,257
Oromia,Guji,Negele Hospital,Hedar,3,2011,28,63,53,144
Oromia,West Guji,Kercha Hospital,Tir,5,2009,88,18,71,177
Oromia,West Arsi,Kokosa,Tahesas,4,2010,23,99,3,125
Oromia,Nekemte Town,Nekemte Town,Tahesas,4,2010,12,73,16,101
Oromia,West Hararge,Daro Lebu,Meskerem,1,2011,13,76,7,96
Oromia,Horo Gudru Wellega,Abe Dengoro,Sene,10,2011,2,61,88,151
Oromia,West Wellega,Ayira Hospital,Tir,5,2010,42,46,93,181
Oromia,East Wellega,Wayu Tuqa,Hamle,11,2010,87,43,76,206
Oromia,West Hararge,Gemechis,Teqemt,2,2011,51,64,47,162
Oromia,South West Shewa,Sodo Dac'Ha,Megabit,7,2009,10,16,33,59
Oromia,West Hararge,Chiro Hospital,Nehase,12,2010,61,23,36,120
Oromia,Finfine Zuria,Sandefa,Sene,10,2009,14,87,19,120
Oromia,West Shewa,Jeldu,Hamle,11,2010,69,88,17,174
Oromia,Qeleme Wellega,Gawo Qebe,Nehase,12,2010,0,35,0,35
Oromia,Finfine Zuria,Akaki,Tir,5,2009,97,68,1,166
Oromia,Arsi,Chole,Tir,5,2011,78,38,29,145
Oromia,Borena,Moyale Hospital,Hamle,11,2009,84,22,16,122
Oromia,West Arsi,Arsi Negele Town,Yekatit,6,2009,63,10,36,109
Oromia,Qeleme Wellega,Seyo,Tahesas,4,2011,20,45,76,141
Oromia,Lege Dadi Lege Tafo Town,Lege Dadi Lege Tafo Town,Miyazia,8,2010,71,59,44,174
Oromia,West Shewa,Jeldu,Tahesas,4,2010,44,49,54,147
Oromia,West Shewa,Ambo Town,Miyazia,8,2009,13,94,27,134
Oromia,Jimma,Gomma,Tir,5,2009,88,32,89,209
Oromia,Horo Gudru Wellega,Abe Dengoro,Miyazia,8,2009,84,73,28,185
Oromia,West Hararge,Tulo,Megabit,7,2010,71,24,23,118
Oromia,East Wellega,Wama Hagelo,Ginbot,9,2009,47,12,54,113
Oromia,Finfine Zuria,Mullo,Nehase,12,2009,14,41,18,73
Oromia,West Wellega,Gimbi Adventist Hospital,Yekatit,6,2010,16,84,61,161
Oromia,Ilu Aba Bora,Bilonopa,Meskerem,1,2010,68,83,76,227
Oromia,West Shewa,Elifata,Nehase,12,2009,45,81,25,151
Oromia,West Arsi,Kofele,Sene,10,2010,72,57,0,129
Oromia,East Shewa,Matahara,Miyazia,8,2009,46,90,2,138
Oromia,West Wellega,Gimbi Adventist Hospital,Miyazia,8,2011,58,70,11,139
Oromia,West Shewa,Guder Hosp,Sene,10,2010,24,34,22,80
Oromia,Finfine Zuria,Walmera,Megabit,7,2009,85,40,16,141
Oromia,Finfine Zuria,Sululta Town,Sene,10,2010,35,10,25,70
Oromia,West Wellega,Haru,Meskerem,1,2010,18,81,86,185
Oromia,Gelan Town,Gelan Town,Tir,5,2010,80,31,85,196
Oromia,West Arsi,Gambo Hospital,Ginbot,9,2010,87,54,30,171
Oromia,East Shewa,Gimbichu,Yekatit,6,2011,82,59,98,239
Oromia,Ilu Aba Bora,Metu Town,Megabit,7,2010,55,25,32,112
Oromia,Robe Town,Robe Town,Tir,5,2011,57,26,67,150
Oromia,Gelan Town,Gelan Town,Megabit,7,2009,32,46,43,121
Oromia,West Wellega,Guliso,Yekatit,6,2010,55,20,76,151
Oromia,Guji,Negele Hospital,Nehase,12,2009,45,7,44,96
Oromia,Guji,Saba Boru,Teqemt,2,2011,36,53,57,146
Oromia,West Hararge,Guba Qoricha,Megabit,7,2010,5,64,24,93
Oromia,Guji,Liben,Teqemt,2,2011,92,39,52,183
Oromia,West Wellega,Nejo Town,Megabit,7,2009,95,27,29,151
Oromia,Ilu Aba Bora,Darimu,Sene,10,2009,75,85,80,240
Oromia,West Wellega,Haru,Tahesas,4,2010,26,72,74,172
Oromia,North Shewa,Dera Hospital,Miyazia,8,2009,7,91,88,186
Oromia,East Hararge,Kombolicha,Ginbot,9,2011,8,53,34,95
Oromia,West Guji,Bule Hora Hospital,Sene,10,2009,98,64,20,182
Oromia,Jimma,Chora Boter,Megabit,7,2010,19,32,54,105
Oromia,Arsi,Digeluna Tijo,Tir,5,2011,88,31,79,198
Oromia,Guji,Aga Wayyu,Yekatit,6,2010,6,14,77,97
Oromia,Guji,Negele Town,Nehase,12,2009,53,66,97,216
Oromia,North Shewa,Were Jarso,Sene,10,2011,77,89,29,195
Oromia,East Hararge,Deder Hospital,Tahesas,4,2010,62,97,38,197
Oromia,West Shewa,Liban Jawi,Hedar,3,2010,21,30,85,136
Oromia,Arsi,Seru,Teqemt,2,2010,31,16,73,120
Oromia,Ilu Aba Bora,Metu Town,Tir,5,2011,68,76,4,148
Oromia,West Wellega,Qiltu Kara,Yekatit,6,2010,50,47,73,170
Oromia,West Wellega,Mendi Hospital,Ginbot,9,2011,21,73,25,119
Oromia,Finfine Zuria,Akaki,Hamle,11,2010,94,79,23,196
Oromia,East Hararge,Fedis,Sene,10,2011,11,56,84,151
Oromia,Arsi,Dodota,Teqemt,2,2011,55,11,40,106
Oromia,Arsi,Tiyo,Miyazia,8,2011,92,39,94,225
Oromia,West Guji,Dugda Dawa,Tahesas,4,2011,49,50,24,123
Oromia,Arsi,Zeway Dugda,Miyazia,8,2009,72,2,24,98
Oromia,West Guji,Gelana,Miyazia,8,2009,89,60,66,215
Oromia,West Wellega,Nole Kaba,Tir,5,2010,84,94,85,263
Oromia,Arsi,Tiyo,Miyazia,8,2011,18,51,18,87
Oromia,West Wellega,Seyo Nole,Miyazia,8,2009,17,15,5,37
